Year,Month,plaza_id,direction,total_vehicles,vehicles_e_zpass,vehicles_vtoll
2010,01,1,I,1105953,678293,427660
2010,01,1,O,1089244,674550,414694
2010,01,2,I,1325788,1012510,313278
2010,01,2,O,1053374,789638,263736
2010,01,3,I,1583758,1080291,503467
2010,01,3,O,1643783,1129751,514032
2010,01,4,I,935337,776493,158844
2010,01,4,O,817107,684249,132858
2010,01,5,I,283938,234109,49829
2010,01,5,O,287122,236697,50425
2010,01,6,I,301163,240826,60337
2010,01,6,O,284732,230218,54514
2010,01,7,I,1174775,934184,240591
2010,01,7,O,976742,801580,175162
2010,01,8,I,658303,552506,105797
2010,01,8,O,592526,506598,85928
2010,01,9,I,1472521,1100526,371995
2010,01,9,O,1552087,1168311,383776
2010,01,11,I,2699696,2139953,559743
2010,02,1,I,963089,587171,375918
2010,02,1,O,954458,587635,366823
2010,02,2,I,1143110,868386,274724
2010,02,2,O,920274,686937,233337
2010,02,3,I,1363450,934122,429328
2010,02,3,O,1421268,978416,442852
2010,02,4,I,783541,648215,135326
2010,02,4,O,697801,581379,116422
2010,02,5,I,236753,194832,41921
2010,02,5,O,238415,196063,42352
2010,02,6,I,258058,205266,52792
2010,02,6,O,243705,195732,47973
2010,02,7,I,1037065,821923,215142
2010,02,7,O,870003,713226,156777
2010,02,8,I,585057,489844,95213
2010,02,8,O,522982,446690,76292
2010,02,9,I,1251655,934904,316751
2010,02,9,O,1313674,987477,326197
2010,02,11,I,2260807,1800201,460606
2010,03,1,I,1207635,745557,462078
2010,03,1,O,1217311,759511,457800
2010,03,2,I,1504705,1150086,354619
2010,03,2,O,1195952,901916,294036
2010,03,3,I,1716900,1187149,529751
2010,03,3,O,1807296,1260014,547282
2010,03,4,I,1012774,835144,177630
2010,03,4,O,905604,750869,154735
2010,03,5,I,310675,255293,55382
2010,03,5,O,320553,263496,57057
2010,03,6,I,333731,265174,68557
2010,03,6,O,317637,255178,62459
2010,03,7,I,1353681,1075407,278274
2010,03,7,O,1113345,913707,199638
2010,03,8,I,740174,618593,121581
2010,03,8,O,665096,565108,99988
2010,03,9,I,1590880,1191631,399249
2010,03,9,O,1635473,1229964,405509
2010,03,11,I,2885236,2300418,584818
2010,04,1,I,1202516,747121,455395
2010,04,1,O,1226414,770444,455970
2010,04,2,I,1501810,1148432,353378
2010,04,2,O,1220607,924902,295705
2010,04,3,I,1738916,1199595,539321
2010,04,3,O,1917435,1346787,570648
2010,04,4,I,1056211,869967,186244
2010,04,4,O,938760,778384,160376
2010,04,5,I,313258,256123,57135
2010,04,5,O,315467,257916,57551
2010,04,6,I,330901,261006,69895
2010,04,6,O,312395,248800,63595
2010,04,7,I,1319208,1047411,271797
2010,04,7,O,1079608,885593,194015
2010,04,8,I,739650,614372,125278
2010,04,8,O,645349,548522,96827
2010,04,9,I,1607193,1199526,407667
2010,04,9,O,1559102,1155185,403917
2010,04,11,I,2881192,2280066,601126
2010,05,1,I,1274191,787140,487051
2010,05,1,O,1307622,818692,488930
2010,05,2,I,1580187,1201587,378600
2010,05,2,O,1297674,978949,318725
2010,05,3,I,1855082,1271076,584006
2010,05,3,O,2106420,1482226,624194
2010,05,4,I,1098475,901928,196547
2010,05,4,O,971721,802995,168726
2010,05,5,I,358364,289403,68961
2010,05,5,O,351502,283737,67765
2010,05,6,I,366994,281844,85150
2010,05,6,O,347434,268631,78803
2010,05,7,I,1374913,1091569,283344
2010,05,7,O,1125544,920377,205167
2010,05,8,I,755948,622891,133057
2010,05,8,O,667809,563638,104171
2010,05,9,I,1699794,1260526,439268
2010,05,9,O,1582131,1153651,428480
2010,05,11,I,3021246,2373588,647658
2010,06,1,I,1274369,799484,474885
2010,06,1,O,1288934,822124,466810
2010,06,2,I,1578180,1215340,362840
2010,06,2,O,1281227,975747,305480
2010,06,3,I,1778733,1223228,555505
2010,06,3,O,2054357,1449129,605228
2010,06,4,I,1091279,896033,195246
2010,06,4,O,942120,781236,160884
2010,06,5,I,388648,311569,77079
2010,06,5,O,382809,307067,75742
2010,06,6,I,389208,290545,98663
2010,06,6,O,366018,275701,90317
2010,06,7,I,1400554,1119628,280926
2010,06,7,O,1127767,929226,198541
2010,06,8,I,777910,641929,135981
2010,06,8,O,668149,567711,100438
2010,06,9,I,1705870,1277798,428072
2010,06,9,O,1558967,1150503,408464
2010,06,11,I,3041551,2399851,641700
2010,07,1,I,1318837,817100,501737
2010,07,1,O,1302559,812215,490344
2010,07,2,I,1520969,1154772,366197
2010,07,2,O,1240658,928820,311838
2010,07,3,I,1768217,1191655,576562
2010,07,3,O,1949373,1328565,620808
2010,07,4,I,1044822,844249,200573
2010,07,4,O,890462,729878,160584
2010,07,5,I,422692,328791,93901
2010,07,5,O,421278,328147,93131
2010,07,6,I,398447,285282,113165
2010,07,6,O,377753,272416,105337
2010,07,7,I,1352304,1067284,285020
2010,07,7,O,1110266,904947,205319
2010,07,8,I,735530,602618,132912
2010,07,8,O,623812,526280,97532
2010,07,9,I,1823294,1348562,474732
2010,07,9,O,1783589,1321422,462167
2010,07,11,I,3047093,2361375,685718
2010,08,1,I,1341430,840782,500648
2010,08,1,O,1317980,832763,485217
2010,08,2,I,1543963,1180921,363042
2010,08,2,O,1252006,941985,310021
2010,08,3,I,1723255,1172211,551044
2010,08,3,O,1886559,1294769,591790
2010,08,4,I,1074783,870258,204525
2010,08,4,O,897707,734587,163120
2010,08,5,I,394423,314890,79533
2010,08,5,O,395819,316236,79583
2010,08,6,I,363481,266801,96680
2010,08,6,O,344534,255384,89150
2010,08,7,I,1395673,1110279,285394
2010,08,7,O,1138933,932090,206843
2010,08,8,I,761100,623351,137749
2010,08,8,O,659553,556747,102806
2010,08,9,I,1876238,1398573,477665
2010,08,9,O,1869406,1402177,467229
2010,08,11,I,3063293,2388325,674968
2010,09,1,I,1277340,817847,459493
2010,09,1,O,1236483,795509,440974
2010,09,2,I,1499720,1166551,333169
2010,09,2,O,1227396,943845,283551
2010,09,3,I,1528657,1064550,464107
2010,09,3,O,1730017,1211362,518655
2010,09,4,I,1062274,871047,191227
2010,09,4,O,892972,740496,152476
2010,09,5,I,331509,270179,61330
2010,09,5,O,333686,271785,61901
2010,09,6,I,328428,250383,78045
2010,09,6,O,307908,237084,70824
2010,09,7,I,1346309,1082844,263465
2010,09,7,O,1104211,914452,189759
2010,09,8,I,742110,612020,130090
2010,09,8,O,647065,547285,99780
2010,09,9,I,1745830,1322587,423243
2010,09,9,O,1739977,1325202,414775
2010,09,11,I,2865970,2272671,593299
2010,10,1,I,1313973,851760,462213
2010,10,1,O,1271751,825903,445848
2010,10,2,I,1558451,1225481,332970
2010,10,2,O,1251895,971015,280880
2010,10,3,I,1489842,1045027,444815
2010,10,3,O,1745546,1233401,512145
2010,10,4,I,1129130,930442,198688
2010,10,4,O,971131,810278,160853
2010,10,5,I,321311,264118,57193
2010,10,5,O,323815,266279,57536
2010,10,6,I,322402,250584,71818
2010,10,6,O,300414,236151,64263
2010,10,7,I,1429773,1154403,275370
2010,10,7,O,1161573,967011,194562
2010,10,8,I,805239,669982,135257
2010,10,8,O,709247,606524,102723
2010,10,9,I,1820716,1391176,429540
2010,10,9,O,1782995,1367209,415786
2010,10,11,I,2978523,2378405,600118
2010,11,1,I,1198570,774453,424117
2010,11,1,O,1193310,776557,416753
2010,11,2,I,1474276,1165466,308810
2010,11,2,O,1169872,908636,261236
2010,11,3,I,1529686,1079000,450686
2010,11,3,O,1673916,1191073,482843
2010,11,4,I,1078259,896862,181397
2010,11,4,O,919421,771570,147851
2010,11,5,I,297601,246433,51168
2010,11,5,O,303307,251223,52084
2010,11,6,I,300906,235471,65435
2010,11,6,O,281829,222937,58892
2010,11,7,I,1333684,1082546,251138
2010,11,7,O,1085892,908106,177786
2010,11,8,I,749557,628842,120715
2010,11,8,O,660822,568357,92465
2010,11,9,I,1665879,1275091,390788
2010,11,9,O,1692352,1300969,391383
2010,11,11,I,2800069,2242491,557578
2010,12,1,I,1121822,724784,397038
2010,12,1,O,1135769,739019,396750
2010,12,2,I,1406680,1101610,305070
2010,12,2,O,1128875,872428,256447
2010,12,3,I,1490005,1048830,441175
2010,12,3,O,1605261,1138619,466642
2010,12,4,I,1005709,830901,174808
2010,12,4,O,861213,720187,141026
2010,12,5,I,279457,231457,48000
2010,12,5,O,286076,237276,48800
2010,12,6,I,287291,224832,62459
2010,12,6,O,269953,213361,56592
2010,12,7,I,1280211,1032634,247577
2010,12,7,O,1073863,891219,182644
2010,12,8,I,725847,609541,116306
2010,12,8,O,636958,546771,90187
2010,12,9,I,1552914,1192977,359937
2010,12,9,O,1592426,1227788,364638
2010,12,11,I,2713081,2174994,538087
2011,01,1,I,993039,663877,329162
2011,01,1,O,1011450,683786,327664
2011,01,2,I,1225474,990004,235470
2011,01,2,O,967735,765406,202329
2011,01,3,I,1365793,991761,374032
2011,01,3,O,1456171,1066534,389637
2011,01,4,I,853813,719928,133885
2011,01,4,O,706866,601396,105470
2011,01,5,I,253651,213846,39805
2011,01,5,O,258304,217451,40853
2011,01,6,I,264222,211286,52936
2011,01,6,O,248070,200434,47636
2011,01,7,I,1136855,946044,190811
2011,01,7,O,932283,795355,136928
2011,01,8,I,640302,548667,91635
2011,01,8,O,559372,492243,67129
2011,01,9,I,1396580,1096385,300195
2011,01,9,O,1433123,1131826,301297
2011,01,11,I,2460330,2009219,451111
2011,02,1,I,973306,649908,323398
2011,02,1,O,997769,673900,323869
2011,02,2,I,1204889,974334,230555
2011,02,2,O,962503,762685,199818
2011,02,3,I,1311551,960212,351339
2011,02,3,O,1384100,1013786,370314
2011,02,4,I,876286,733179,143107
2011,02,4,O,736160,623342,112818
2011,02,5,I,244056,205201,38855
2011,02,5,O,249507,209603,39904
2011,02,6,I,256544,203921,52623
2011,02,6,O,241001,193750,47251
2011,02,7,I,1132220,941528,190692
2011,02,7,O,942509,807306,135203
2011,02,8,I,654345,561019,93326
2011,02,8,O,584756,513267,71489
2011,02,9,I,1369598,1074921,294677
2011,02,9,O,1419228,1121322,297906
2011,02,11,I,2409370,1975078,434292
2011,03,1,I,1161525,786223,375302
2011,03,1,O,1187816,812210,375606
2011,03,2,I,1459428,1187679,271749
2011,03,2,O,1169927,935163,234764
2011,03,3,I,1505526,1105520,400006
2011,03,3,O,1637094,1209753,427341
2011,03,4,I,1028119,863199,164920
2011,03,4,O,874536,743174,131362
2011,03,5,I,302827,254665,48162
2011,03,5,O,305225,257229,47996
2011,03,6,I,311616,249311,62305
2011,03,6,O,290854,235676,55178
2011,03,7,I,1367940,1142454,225486
2011,03,7,O,1138836,979161,159675
2011,03,8,I,774705,664947,109758
2011,03,8,O,671909,592894,79015
2011,03,9,I,1656034,1307367,348667
2011,03,9,O,1673166,1328911,344255
2011,03,11,I,2820987,2324448,496539
2011,04,1,I,1153348,778644,374704
2011,04,1,O,1173216,797243,375973
2011,04,2,I,1428245,1152051,276194
2011,04,2,O,1160558,923482,237076
2011,04,3,I,1495804,1090366,405438
2011,04,3,O,1638612,1202477,436135
2011,04,4,I,1034515,868071,166444
2011,04,4,O,874303,742173,132130
2011,04,5,I,281968,236248,45720
2011,04,5,O,282157,236320,45837
2011,04,6,I,294790,234594,60196
2011,04,6,O,275591,221912,53679
2011,04,7,I,1316162,1092233,223929
2011,04,7,O,1091693,932443,159250
2011,04,8,I,730722,621360,109362
2011,04,8,O,653815,569829,83986
2011,04,9,I,1682588,1320255,362333
2011,04,9,O,1692311,1334954,357357
2011,04,11,I,2781243,2260276,520967
2011,05,1,I,1201993,817007,384986
2011,05,1,O,1232853,843878,388975
2011,05,2,I,1545661,1246665,298996
2011,05,2,O,1267745,1011581,256164
2011,05,3,I,1566744,1136811,429933
2011,05,3,O,1713742,1250352,463390
2011,05,4,I,1054521,884001,170520
2011,05,4,O,894643,756499,138144
2011,05,5,I,338388,281913,56475
2011,05,5,O,335671,279674,55997
2011,05,6,I,331467,258891,72576
2011,05,6,O,310850,245100,65750
2011,05,7,I,1398741,1162268,236473
2011,05,7,O,1152429,983159,169270
2011,05,8,I,781154,664289,116865
2011,05,8,O,712364,619100,93264
2011,05,9,I,1799312,1413038,386274
2011,05,9,O,1832512,1448321,384191
2011,05,11,I,2911735,2368053,543682
2011,06,1,I,1201861,824284,377577
2011,06,1,O,1228580,848801,379779
2011,06,2,I,1555412,1255041,300371
2011,06,2,O,1267349,1011132,256217
2011,06,3,I,1585854,1147867,437987
2011,06,3,O,1734973,1258807,476166
2011,06,4,I,1077341,899400,177941
2011,06,4,O,895008,755376,139632
2011,06,5,I,360839,296838,64001
2011,06,5,O,358270,295591,62679
2011,06,6,I,354528,270535,83993
2011,06,6,O,332058,255556,76502
2011,06,7,I,1384190,1148601,235589
2011,06,7,O,1145118,976338,168780
2011,06,8,I,795756,673624,122132
2011,06,8,O,725719,628583,97136
2011,06,9,I,1803165,1418350,384815
2011,06,9,O,1826210,1442706,383504
2011,06,11,I,2951815,2397639,554176
2011,07,1,I,1225435,826626,398809
2011,07,1,O,1262770,856293,406477
2011,07,2,I,1481970,1176921,305049
2011,07,2,O,1229786,960987,268799
2011,07,3,I,1636582,1155092,481490
2011,07,3,O,1792944,1274634,518310
2011,07,4,I,1043813,864902,178911
2011,07,4,O,875869,730905,144964
2011,07,5,I,419269,332064,87205
2011,07,5,O,414477,329182,85295
2011,07,6,I,384057,275486,108571
2011,07,6,O,362983,261579,101404
2011,07,7,I,1304801,1066199,238602
2011,07,7,O,1078882,906412,172470
2011,07,8,I,739399,618896,120503
2011,07,8,O,706908,603195,103713
2011,07,9,I,1902816,1469297,433519
2011,07,9,O,1928568,1498851,429717
2011,07,11,I,2961990,2355576,606414
2011,08,1,I,1172694,808526,364168
2011,08,1,O,1212199,844254,367945
2011,08,2,I,1420013,1142547,277466
2011,08,2,O,1161719,918775,242944
2011,08,3,I,1532272,1115182,417090
2011,08,3,O,1681244,1228767,452477
2011,08,4,I,998939,833691,165248
2011,08,4,O,816366,686103,130263
2011,08,5,I,360310,299839,60471
2011,08,5,O,356605,297640,58965
2011,08,6,I,327555,255551,72004
2011,08,6,O,308308,242018,66290
2011,08,7,I,1323610,1095449,228161
2011,08,7,O,1090895,927289,163606
2011,08,8,I,752134,634447,117687
2011,08,8,O,702703,606157,96546
2011,08,9,I,1755079,1389979,365100
2011,08,9,O,1783953,1418753,365200
2011,08,11,I,2798397,2279825,518572
2011,09,1,I,1137361,799614,337747
2011,09,1,O,1183891,840559,343332
2011,09,2,I,1414607,1153520,261087
2011,09,2,O,1161480,936870,224610
2011,09,3,I,1450614,1059076,391538
2011,09,3,O,1580249,1161286,418963
2011,09,4,I,974262,822512,151750
2011,09,4,O,812623,691234,121389
2011,09,5,I,314788,263983,50805
2011,09,5,O,315745,264521,51224
2011,09,6,I,306526,244080,62446
2011,09,6,O,287904,231200,56704
2011,09,7,I,1303440,1085984,217456
2011,09,7,O,1082821,926546,156275
2011,09,8,I,725116,616359,108757
2011,09,8,O,662445,575796,86649
2011,09,9,I,1689742,1344278,345464
2011,09,9,O,1717674,1372657,345017
2011,09,11,I,2717916,2228671,489245
2011,10,1,I,1148376,808734,339642
2011,10,1,O,1203174,855893,347281
2011,10,2,I,1452497,1196935,255562
2011,10,2,O,1157887,942883,215004
2011,10,3,I,1485340,1094034,391306
2011,10,3,O,1646805,1220244,426561
2011,10,4,I,1044237,890214,154023
2011,10,4,O,879331,753473,125858
2011,10,5,I,304945,257093,47852
2011,10,5,O,305784,257866,47918
2011,10,6,I,308844,247738,61106
2011,10,6,O,289227,234323,54904
2011,10,7,I,1422866,1189677,233189
2011,10,7,O,1142453,982919,159534
2011,10,8,I,760048,649764,110284
2011,10,8,O,723439,629776,93663
2011,10,9,I,1731044,1381712,349332
2011,10,9,O,1769548,1420642,348906
2011,10,11,I,2792930,2301004,491926
2011,11,1,I,1108782,786302,322480
2011,11,1,O,1169535,833638,335897
2011,11,2,I,1404388,1153190,251198
2011,11,2,O,1115699,907088,208611
2011,11,3,I,1510131,1116593,393538
2011,11,3,O,1699239,1278173,421066
2011,11,4,I,1034255,882190,152065
2011,11,4,O,871972,750202,121770
2011,11,5,I,295991,251070,44921
2011,11,5,O,299566,254269,45297
2011,11,6,I,295284,237809,57475
2011,11,6,O,277301,225717,51584
2011,11,7,I,1340581,1125614,214967
2011,11,7,O,1124256,967340,156916
2011,11,8,I,755815,646555,109260
2011,11,8,O,686437,602747,83690
2011,11,9,I,1650378,1315639,334739
2011,11,9,O,1615671,1286139,329532
2011,11,11,I,2731952,2251250,480702
2011,12,1,I,1104910,773654,331256
2011,12,1,O,1169969,825155,344814
2011,12,2,I,1387726,1129545,258181
2011,12,2,O,1118990,897100,221890
2011,12,3,I,1539939,1128357,411582
2011,12,3,O,1672873,1232859,440014
2011,12,4,I,1034163,874210,159953
2011,12,4,O,866607,742043,124564
2011,12,5,I,307493,261298,46195
2011,12,5,O,305543,259881,45662
2011,12,6,I,302811,243686,59125
2011,12,6,O,283093,229857,53236
2011,12,7,I,1311597,1098397,213200
2011,12,7,O,1117598,956619,160979
2011,12,8,I,771676,660420,111256
2011,12,8,O,690667,605891,84776
2011,12,9,I,1621524,1285968,335556
2011,12,9,O,1656664,1320276,336388
2011,12,11,I,2842502,2336618,505884
2012,01,1,I,1021744,722653,299091
2012,01,1,O,1076170,771065,305105
2012,01,2,I,1284134,1061081,223053
2012,01,2,O,1011316,819491,191825
2012,01,3,I,1434539,1064411,370128
2012,01,3,O,1540261,1152015,388246
2012,01,4,I,938576,808764,129812
2012,01,4,O,783144,683489,99655
2012,01,5,I,275250,235535,39715
2012,01,5,O,280775,240048,40727
2012,01,6,I,287586,233541,54045
2012,01,6,O,270420,221944,48476
2012,01,7,I,1218963,1037316,181647
2012,01,7,O,1025076,890092,134984
2012,01,8,I,700307,606433,93874
2012,01,8,O,629261,558334,70927
2012,01,9,I,1488952,1194148,294804
2012,01,9,O,1524969,1230767,294202
2012,01,11,I,2612764,2169791,442973
2012,02,1,I,972051,682935,289116
2012,02,1,O,1015817,721182,294635
2012,02,2,I,1194330,980382,213948
2012,02,2,O,955911,771229,184682
2012,02,3,I,1356594,1005418,351176
2012,02,3,O,1468031,1095037,372994
2012,02,4,I,886356,762218,124138
2012,02,4,O,743555,645934,97621
2012,02,5,I,251318,214824,36494
2012,02,5,O,257818,220166,37652
2012,02,6,I,265634,214076,51558
2012,02,6,O,249395,202870,46525
2012,02,7,I,1152264,978611,173653
2012,02,7,O,985861,857536,128325
2012,02,8,I,679630,585777,93853
2012,02,8,O,591422,524524,66898
2012,02,9,I,1404137,1121814,282323
2012,02,9,O,1444275,1159433,284842
2012,02,11,I,2440362,2027636,412726
2012,03,1,I,1125862,794308,331554
2012,03,1,O,1185512,848779,336733
2012,03,2,I,1427588,1182196,245392
2012,03,2,O,1149507,935389,214118
2012,03,3,I,1579937,1177027,402910
2012,03,3,O,1693842,1265399,428443
2012,03,4,I,1017924,872337,145587
2012,03,4,O,859408,743748,115660
2012,03,5,I,303476,260196,43280
2012,03,5,O,307264,263432,43832
2012,03,6,I,314174,254341,59833
2012,03,6,O,295217,241047,54170
2012,03,7,I,1373954,1167802,206152
2012,03,7,O,1157495,1008558,148937
2012,03,8,I,798956,688383,110573
2012,03,8,O,695776,614691,81085
2012,03,9,I,1624964,1307647,317317
2012,03,9,O,1674940,1355765,319175
2012,03,11,I,2806084,2336329,469755
2012,04,1,I,1113487,790506,322981
2012,04,1,O,1175388,847077,328311
2012,04,2,I,1416108,1174564,241544
2012,04,2,O,1156569,944289,212280
2012,04,3,I,1576075,1170901,405174
2012,04,3,O,1682245,1256741,425504
2012,04,4,I,1030756,882009,148747
2012,04,4,O,879419,758445,120974
2012,04,5,I,291618,248303,43315
2012,04,5,O,288295,245582,42713
2012,04,6,I,302279,243894,58385
2012,04,6,O,282743,229946,52797
2012,04,7,I,1327383,1129142,198241
2012,04,7,O,1117370,971311,146059
2012,04,8,I,743558,641272,102286
2012,04,8,O,690696,607616,83080
2012,04,9,I,1624724,1308281,316443
2012,04,9,O,1675220,1355195,320025
2012,04,11,I,2751291,2270372,480919
2012,05,1,I,1174445,837073,337372
2012,05,1,O,1241435,898176,343259
2012,05,2,I,1536104,1276510,259594
2012,05,2,O,1265008,1036165,228843
2012,05,3,I,1659542,1237021,422521
2012,05,3,O,1786056,1339306,446750
2012,05,4,I,1092285,934716,157569
2012,05,4,O,928007,799592,128415
2012,05,5,I,340886,290120,50766
2012,05,5,O,340605,290306,50299
2012,05,6,I,344753,275402,69351
2012,05,6,O,322536,259661,62875
2012,05,7,I,1412502,1204912,207590
2012,05,7,O,1168489,1016593,151896
2012,05,8,I,792869,684211,108658
2012,05,8,O,755193,660370,94823
2012,05,9,I,1730211,1395761,334450
2012,05,9,O,1798143,1458521,339622
2012,05,11,I,2879231,2387511,491720
2012,06,1,I,1172915,836005,336910
2012,06,1,O,1229731,886433,343298
2012,06,2,I,1539477,1274816,264661
2012,06,2,O,1259775,1028298,231477
2012,06,3,I,1727302,1280370,446932
2012,06,3,O,1787304,1328377,458927
2012,06,4,I,1067022,901810,165212
2012,06,4,O,915427,780040,135387
2012,06,5,I,378312,315898,62414
2012,06,5,O,369988,309648,60340
2012,06,6,I,370403,286520,83883
2012,06,6,O,349021,271690,77331
2012,06,7,I,1381670,1175613,206057
2012,06,7,O,1137824,988126,149698
2012,06,8,I,798505,683843,114662
2012,06,8,O,727680,635666,92014
2012,06,9,I,1664046,1339377,324669
2012,06,9,O,1796980,1447012,349968
2012,06,11,I,2904382,2394710,509672
2012,07,1,I,1164484,817693,346791
2012,07,1,O,1206529,857294,349235
2012,07,2,I,1439768,1185617,254151
2012,07,2,O,1186566,954746,231820
2012,07,3,I,1720852,1261990,458862
2012,07,3,O,1823845,1342547,481298
2012,07,4,I,997121,836152,160969
2012,07,4,O,846154,717389,128765
2012,07,5,I,402131,330605,71526
2012,07,5,O,400197,329858,70339
2012,07,6,I,378133,288436,89697
2012,07,6,O,360193,276561,83632
2012,07,7,I,1333258,1129203,204055
2012,07,7,O,1101879,950372,151507
2012,07,8,I,735840,630761,105079
2012,07,8,O,713791,618915,94876
2012,07,9,I,1747803,1389506,358297
2012,07,9,O,1819733,1452847,366886
2012,07,11,I,2861845,2328145,533700
2012,08,1,I,1202534,853889,348645
2012,08,1,O,1245564,892013,353551
2012,08,2,I,1500805,1237038,263767
2012,08,2,O,1238074,1002923,235151
2012,08,3,I,1771658,1317259,454399
2012,08,3,O,1877162,1400038,477124
2012,08,4,I,1003643,844449,159194
2012,08,4,O,877389,746513,130876
2012,08,5,I,398383,334096,64287
2012,08,5,O,390310,327883,62427
2012,08,6,I,372820,292108,80712
2012,08,6,O,351894,277520,74374
2012,08,7,I,1384799,1176963,207836
2012,08,7,O,1158361,1004168,154193
2012,08,8,I,780236,669212,111024
2012,08,8,O,755627,656009,99618
2012,08,9,I,1808786,1449933,358853
2012,08,9,O,1863257,1496792,366465
2012,08,11,I,2961780,2430779,531001
2012,09,1,I,1108212,792195,316017
2012,09,1,O,1168846,843760,325086
2012,09,2,I,1420946,1184447,236499
2012,09,2,O,1183516,968429,215087
2012,09,3,I,1601001,1200533,400468
2012,09,3,O,1701527,1282469,419058
2012,09,4,I,994414,852787,141627
2012,09,4,O,852119,738213,113906
2012,09,5,I,316025,270377,45648
2012,09,5,O,318058,272412,45646
2012,09,6,I,323597,263986,59611
2012,09,6,O,305265,251325,53940
2012,09,7,I,1326628,1136042,190586
2012,09,7,O,1101847,959731,142116
2012,09,8,I,726179,627393,98786
2012,09,8,O,719213,627652,91561
2012,09,9,I,1652478,1333620,318858
2012,09,9,O,1726875,1401933,324942
2012,09,11,I,2718283,2248236,470047
2012,10,1,I,1110517,806445,304072
2012,10,1,O,1180917,871626,309291
2012,10,2,I,1425051,1198979,226072
2012,10,2,O,1169753,968549,201204
2012,10,3,I,1546380,1184301,362079
2012,10,3,O,1653334,1268120,385214
2012,10,4,I,984711,853081,131630
2012,10,4,O,847500,743096,104404
2012,10,5,I,291761,253988,37773
2012,10,5,O,295553,257655,37898
2012,10,6,I,301421,251587,49834
2012,10,6,O,278322,234486,43836
2012,10,7,I,1239988,1067710,172278
2012,10,7,O,1031610,906776,124834
2012,10,8,I,746064,645976,100088
2012,10,8,O,680066,599221,80845
2012,10,9,I,1552343,1267531,284812
2012,10,9,O,1578013,1282896,295117
2012,10,11,I,2639933,2212558,427375
2012,11,1,I,1079920,786075,293845
2012,11,1,O,1129485,832091,297394
2012,11,2,I,1333772,1126619,207153
2012,11,2,O,1109319,918530,190789
2012,11,3,I,1552364,1179626,372738
2012,11,3,O,1712344,1313047,399297
2012,11,4,I,875378,773651,101727
2012,11,4,O,753093,671583,81510
2012,11,5,I,226726,219907,6819
2012,11,5,O,222821,216533,6288
2012,11,6,I,184236,179720,4516
2012,11,6,O,182151,177785,4366
2012,11,7,I,854436,731062,123374
2012,11,7,O,715477,622333,93144
2012,11,8,I,279612,245703,33909
2012,11,8,O,218932,196332,22600
2012,11,9,I,1533052,1236071,296981
2012,11,9,O,1501196,1200817,300379
2012,11,11,I,2638932,2178556,460376
2012,12,1,I,1087639,784074,303565
2012,12,1,O,1153469,837192,316277
2012,12,2,I,1397407,1164514,232893
2012,12,2,O,1138992,931504,207488
2012,12,3,I,1572372,1183226,389146
2012,12,3,O,1709833,1294498,415335
2012,12,4,I,966825,853403,113422
2012,12,4,O,817831,725519,92312
2012,12,5,I,341537,276908,64629
2012,12,5,O,339840,275307,64533
2012,12,6,I,339904,267396,72508
2012,12,6,O,321214,253225,67989
2012,12,7,I,1250967,1068395,182572
2012,12,7,O,1053786,915306,138480
2012,12,8,I,714397,621489,92908
2012,12,8,O,594284,530159,64125
2012,12,9,I,1580541,1272175,308366
2012,12,9,O,1620946,1311257,309689
2012,12,11,I,2815590,2331196,484394
2013,01,1,I,1046704,767937,278767
2013,01,1,O,1097840,812281,285559
2013,01,2,I,1337578,1129993,207585
2013,01,2,O,1050662,870319,180343
2013,01,3,I,1508887,1153943,354944
2013,01,3,O,1635174,1258885,376289
2013,01,4,I,922645,824390,98255
2013,01,4,O,770677,691320,79357
2013,01,5,I,325652,273181,52471
2013,01,5,O,327507,274164,53343
2013,01,6,I,340019,275608,64411
2013,01,6,O,320001,261121,58880
2013,01,7,I,1192275,1033875,158400
2013,01,7,O,975487,863319,112168
2013,01,8,I,714756,628434,86322
2013,01,8,O,610680,548455,62225
2013,01,9,I,1512266,1235931,276335
2013,01,9,O,1542506,1269968,272538
2013,01,11,I,2648107,2228934,419173
2013,02,1,I,935084,684914,250170
2013,02,1,O,995648,734148,261500
2013,02,2,I,1204353,1016334,188019
2013,02,2,O,950143,786995,163148
2013,02,3,I,1335511,1024966,310545
2013,02,3,O,1448780,1118723,330057
2013,02,4,I,816694,728518,88176
2013,02,4,O,691945,618951,72994
2013,02,5,I,270628,229799,40829
2013,02,5,O,274282,232728,41554
2013,02,6,I,293640,241411,52229
2013,02,6,O,273664,226305,47359
2013,02,7,I,1081942,938017,143925
2013,02,7,O,893543,792175,101368
2013,02,8,I,660987,580753,80234
2013,02,8,O,552423,497402,55021
2013,02,9,I,1317309,1076770,240539
2013,02,9,O,1354539,1113556,240983
2013,02,11,I,2350218,1985675,364543
2013,03,1,I,1098878,807708,291170
2013,03,1,O,1166990,864821,302169
2013,03,2,I,1400888,1186787,214101
2013,03,2,O,1129490,938448,191042
2013,03,3,I,1596388,1231296,365092
2013,03,3,O,1725211,1337414,387797
2013,03,4,I,948110,843627,104483
2013,03,4,O,810579,723438,87141
2013,03,5,I,307755,263087,44668
2013,03,5,O,309407,264539,44868
2013,03,6,I,331544,274889,56655
2013,03,6,O,309495,258058,51437
2013,03,7,I,1297209,1129711,167498
2013,03,7,O,1079525,959651,119874
2013,03,8,I,727795,640404,87391
2013,03,8,O,621398,557983,63415
2013,03,9,I,1604504,1310550,293954
2013,03,9,O,1641399,1348380,293019
2013,03,11,I,2742873,2310622,432251
2013,04,1,I,1112322,828470,283852
2013,04,1,O,1182305,889229,293076
2013,04,2,I,1493571,1277153,216418
2013,04,2,O,1191936,1003927,188009
2013,04,3,I,1618373,1259928,358445
2013,04,3,O,1743032,1361415,381617
2013,04,4,I,1008386,901037,107349
2013,04,4,O,852249,764746,87503
2013,04,5,I,323390,277804,45586
2013,04,5,O,320858,275752,45106
2013,04,6,I,342118,286387,55731
2013,04,6,O,317771,267522,50249
2013,04,7,I,1223515,1063745,159770
2013,04,7,O,995195,888430,106765
2013,04,8,I,775979,683706,92273
2013,04,8,O,652751,587037,65714
2013,04,9,I,1600662,1313769,286893
2013,04,9,O,1663736,1376849,286887
2013,04,11,I,2723552,2309260,414292
2013,05,1,I,1171038,868325,302713
2013,05,1,O,1248325,934586,313739
2013,05,2,I,1540556,1310342,230214
2013,05,2,O,1255743,1052715,203028
2013,05,3,I,1698976,1317752,381224
2013,05,3,O,1850839,1443364,407475
2013,05,4,I,1054131,938680,115451
2013,05,4,O,900093,802332,97761
2013,05,5,I,356461,306575,49886
2013,05,5,O,349639,300837,48802
2013,05,6,I,366027,303830,62197
2013,05,6,O,338712,282365,56347
2013,05,7,I,1360130,1185582,174548
2013,05,7,O,1117644,992152,125492
2013,05,8,I,786067,690655,95412
2013,05,8,O,659507,592014,67493
2013,05,9,I,1726411,1416365,310046
2013,05,9,O,1777434,1467776,309658
2013,05,11,I,2858191,2413455,444736
2013,06,1,I,1177918,870672,307246
2013,06,1,O,1238221,921720,316501
2013,06,2,I,1498579,1267650,230929
2013,06,2,O,1219899,1015474,204425
2013,06,3,I,1582966,1213179,369787
2013,06,3,O,1753204,1348006,405198
2013,06,4,I,1010942,892395,118547
2013,06,4,O,862698,757990,104708
2013,06,5,I,375760,317962,57798
2013,06,5,O,368317,312082,56235
2013,06,6,I,370015,297259,72756
2013,06,6,O,346976,279538,67438
2013,06,7,I,1298708,1129425,169283
2013,06,7,O,1072297,949567,122730
2013,06,8,I,778273,680995,97278
2013,06,8,O,647025,577926,69099
2013,06,9,I,1775307,1448979,326328
2013,06,9,O,1803705,1479375,324330
2013,06,11,I,2846718,2385156,461562
2013,07,1,I,1186468,872322,314146
2013,07,1,O,1249654,929407,320247
2013,07,2,I,1473156,1242629,230527
2013,07,2,O,1169732,965741,203991
2013,07,3,I,1665632,1267090,398542
2013,07,3,O,1820634,1392218,428416
2013,07,4,I,1005318,878391,126927
2013,07,4,O,824103,721261,102842
2013,07,5,I,405723,337097,68626
2013,07,5,O,396253,330230,66023
2013,07,6,I,385559,302025,83534
2013,07,6,O,362728,285390,77338
2013,07,7,I,1280565,1104600,175965
2013,07,7,O,1043617,918647,124970
2013,07,8,I,752573,656763,95810
2013,07,8,O,642512,572294,70218
2013,07,9,I,1812058,1468861,343197
2013,07,9,O,1824700,1483957,340743
2013,07,11,I,2844114,2366316,477798
2013,08,1,I,1234046,918629,315417
2013,08,1,O,1286741,967202,319539
2013,08,2,I,1531543,1281696,249847
2013,08,2,O,1251878,1029767,222111
2013,08,3,I,1690734,1295127,395607
2013,08,3,O,1918617,1481127,437490
2013,08,4,I,1023688,888789,134899
2013,08,4,O,848327,740174,108153
2013,08,5,I,382335,324850,57485
2013,08,5,O,374978,319513,55465
2013,08,6,I,361007,291681,69326
2013,08,6,O,340411,276762,63649
2013,08,7,I,1361784,1171580,190204
2013,08,7,O,1134741,993681,141060
2013,08,8,I,806762,698175,108587
2013,08,8,O,682848,602462,80386
2013,08,9,I,1850982,1504487,346495
2013,08,9,O,1840609,1498108,342501
2013,08,11,I,2927251,2438853,488398
2013,09,1,I,1146451,857687,288764
2013,09,1,O,1217511,921864,295647
2013,09,2,I,1469965,1252860,217105
2013,09,2,O,1190493,999134,191359
2013,09,3,I,1531564,1190185,341379
2013,09,3,O,1756031,1380472,375559
2013,09,4,I,1004235,888114,116121
2013,09,4,O,839170,742615,96555
2013,09,5,I,311695,269932,41763
2013,09,5,O,312684,270818,41866
2013,09,6,I,324786,271788,52998
2013,09,6,O,306081,257910,48171
2013,09,7,I,1316313,1147443,168870
2013,09,7,O,1103447,977226,126221
2013,09,8,I,761564,664393,97171
2013,09,8,O,631205,565318,65887
2013,09,9,I,1693056,1391856,301200
2013,09,9,O,1677745,1383925,293820
2013,09,11,I,2671606,2255593,416013
2013,10,1,I,1209559,917306,292253
2013,10,1,O,1276003,978353,297650
2013,10,2,I,1585161,1362330,222831
2013,10,2,O,1251470,1060592,190878
2013,10,3,I,1536979,1213870,323109
2013,10,3,O,1808794,1445751,363043
2013,10,4,I,1098156,975156,123000
2013,10,4,O,927629,828483,99146
2013,10,5,I,314114,274897,39217
2013,10,5,O,318346,278667,39679
2013,10,6,I,331758,282520,49238
2013,10,6,O,311773,267304,44469
2013,10,7,I,1392420,1219098,173322
2013,10,7,O,1168734,1042026,126708
2013,10,8,I,911397,799476,111921
2013,10,8,O,719186,648414,70772
2013,10,9,I,1744363,1449383,294980
2013,10,9,O,1712480,1426430,286050
2013,10,11,I,2818279,2407218,411061
2013,11,1,I,1146290,862639,283651
2013,11,1,O,1178659,893804,284855
2013,11,2,I,1415633,1208784,206849
2013,11,2,O,1125101,945692,179409
2013,11,3,I,1453461,1140139,313322
2013,11,3,O,1662535,1310926,351609
2013,11,4,I,1019980,905891,114089
2013,11,4,O,858418,766260,92158
2013,11,5,I,290016,254171,35845
2013,11,5,O,294089,257653,36436
2013,11,6,I,304554,258480,46074
2013,11,6,O,286980,245488,41492
2013,11,7,I,1287983,1127374,160609
2013,11,7,O,1079159,962483,116676
2013,11,8,I,819226,716749,102477
2013,11,8,O,649188,584266,64922
2013,11,9,I,1640040,1353914,286126
2013,11,9,O,1655017,1376538,278479
2013,11,11,I,2630085,2230785,399300
2013,12,1,I,1106368,823491,282877
2013,12,1,O,1174933,885108,289825
2013,12,2,I,1413813,1200539,213274
2013,12,2,O,1112544,929352,183192
2013,12,3,I,1477234,1151297,325937
2013,12,3,O,1665905,1305204,360701
2013,12,4,I,982655,865492,117163
2013,12,4,O,816701,722798,93903
2013,12,5,I,284740,250058,34682
2013,12,5,O,289850,254648,35202
2013,12,6,I,301221,256528,44693
2013,12,6,O,285335,244915,40420
2013,12,7,I,1300248,1129981,170267
2013,12,7,O,1068585,945462,123123
2013,12,8,I,772161,682245,89916
2013,12,8,O,626457,567324,59133
2013,12,9,I,1571166,1293581,277585
2013,12,9,O,1612798,1336124,276674
2013,12,11,I,2693297,2280129,413168
2014,01,1,I,999119,755205,243914
2014,01,1,O,1067554,817410,250144
2014,01,2,I,1281153,1100758,180395
2014,01,2,O,985384,830522,154862
2014,01,3,I,1361095,1074396,286699
2014,01,3,O,1491892,1183806,308086
2014,01,4,I,868598,774644,93954
2014,01,4,O,733644,656695,76949
2014,01,5,I,258421,228494,29927
2014,01,5,O,262831,232278,30553
2014,01,6,I,281710,241776,39934
2014,01,6,O,266897,231543,35354
2014,01,7,I,1181297,1039431,141866
2014,01,7,O,979038,875938,103100
2014,01,8,I,695247,621010,74237
2014,01,8,O,574942,524985,49957
2014,01,9,I,1422129,1186821,235308
2014,01,9,O,1452217,1220239,231978
2014,01,11,I,2399767,2055028,344739
2014,02,1,I,910032,683582,226450
2014,02,1,O,961206,728706,232500
2014,02,2,I,1144825,977892,166933
2014,02,2,O,908509,763325,145184
2014,02,3,I,1227162,970912,256250
2014,02,3,O,1355299,1075608,279691
2014,02,4,I,758437,675546,82891
2014,02,4,O,661403,589705,71698
2014,02,5,I,227060,199919,27141
2014,02,5,O,235378,207472,27906
2014,02,6,I,255443,217980,37463
2014,02,6,O,244574,210945,33629
2014,02,7,I,1058767,932709,126058
2014,02,7,O,897936,805159,92777
2014,02,8,I,624423,555712,68711
2014,02,8,O,520497,474252,46245
2014,02,9,I,1294902,1075873,219029
2014,02,9,O,1306218,1093168,213050
2014,02,11,I,2151715,1846515,305200
2014,03,1,I,1139985,853655,286330
2014,03,1,O,1196549,904942,291607
2014,03,2,I,1444533,1234095,210438
2014,03,2,O,1135581,954742,180839
2014,03,3,I,1520781,1194646,326135
2014,03,3,O,1665178,1312001,353177
2014,03,4,I,973075,865707,107368
2014,03,4,O,838608,747244,91364
2014,03,5,I,284425,250842,33583
2014,03,5,O,292756,258477,34279
2014,03,6,I,317159,270210,46949
2014,03,6,O,301209,259200,42009
2014,03,7,I,1355222,1190835,164387
2014,03,7,O,1138090,1018078,120012
2014,03,8,I,778625,691201,87424
2014,03,8,O,654915,594430,60485
2014,03,9,I,1618129,1340503,277626
2014,03,9,O,1666329,1392238,274091
2014,03,11,I,2665802,2280034,385768
2014,04,1,I,1181271,890454,290817
2014,04,1,O,1230632,935140,295492
2014,04,2,I,1477564,1261026,216538
2014,04,2,O,1164394,981321,183073
2014,04,3,I,1531733,1204534,327199
2014,04,3,O,1697719,1337327,360392
2014,04,4,I,1012690,897459,115231
2014,04,4,O,879462,782016,97446
2014,04,5,I,283323,248677,34646
2014,04,5,O,289690,254324,35366
2014,04,6,I,317123,268771,48352
2014,04,6,O,300043,257053,42990
2014,04,7,I,1359466,1193129,166337
2014,04,7,O,1119994,999020,120974
2014,04,8,I,783637,692460,91177
2014,04,8,O,635282,575167,60115
2014,04,9,I,1670243,1383634,286609
2014,04,9,O,1724811,1442059,282752
2014,04,11,I,2701077,2302562,398515
2014,05,1,I,1275057,961828,313229
2014,05,1,O,1323770,1003454,320316
2014,05,2,I,1625480,1382780,242700
2014,05,2,O,1302377,1094563,207814
2014,05,3,I,1620293,1269044,351249
2014,05,3,O,1786426,1401197,385229
2014,05,4,I,1094048,962813,131235
2014,05,4,O,940684,831347,109337
2014,05,5,I,335834,292983,42851
2014,05,5,O,340548,297172,43376
2014,05,6,I,349687,293357,56330
2014,05,6,O,328400,277743,50657
2014,05,7,I,1426098,1249100,176998
2014,05,7,O,1187878,1056520,131358
2014,05,8,I,833541,736235,97306
2014,05,8,O,685034,618394,66640
2014,05,9,I,1786470,1471983,314487
2014,05,9,O,1898799,1581116,317683
2014,05,11,I,2861975,2431462,430513
2014,06,1,I,1271908,959487,312421
2014,06,1,O,1310826,992451,318375
2014,06,2,I,1581547,1337650,243897
2014,06,2,O,1272420,1063876,208544
2014,06,3,I,1592866,1244189,348677
2014,06,3,O,1775429,1390252,385177
2014,06,4,I,1063699,927545,136154
2014,06,4,O,915332,800119,115213
2014,06,5,I,365083,312597,52486
2014,06,5,O,362613,311200,51413
2014,06,6,I,370219,300243,69976
2014,06,6,O,350427,286352,64075
2014,06,7,I,1399685,1226322,173363
2014,06,7,O,1167605,1037256,130349
2014,06,8,I,828191,727087,101104
2014,06,8,O,660263,594043,66220
2014,06,9,I,1794593,1475661,318932
2014,06,9,O,1827900,1514506,313394
2014,06,11,I,2825302,2389137,436165
2014,07,1,I,1281682,961432,320250
2014,07,1,O,1323899,998402,325497
2014,07,2,I,1538068,1296437,241631
2014,07,2,O,1242700,1033225,209475
2014,07,3,I,1640532,1272835,367697
2014,07,3,O,1815862,1414360,401502
2014,07,4,I,1030292,890596,139696
2014,07,4,O,882742,765768,116974
2014,07,5,I,379776,322867,56909
2014,07,5,O,380645,324243,56402
2014,07,6,I,371302,298777,72525
2014,07,6,O,353335,286213,67122
2014,07,7,I,1358050,1186277,171773
2014,07,7,O,1134307,1005494,128813
2014,07,8,I,804925,705618,99307
2014,07,8,O,651274,583859,67415
2014,07,9,I,1873368,1532137,341231
2014,07,9,O,1889466,1556873,332593
2014,07,11,I,2847379,2394405,452974
2014,08,1,I,1322884,993299,329585
2014,08,1,O,1353311,1017689,335622
2014,08,2,I,1553114,1300481,252633
2014,08,2,O,1277318,1056899,220419
2014,08,3,I,1670797,1291963,378834
2014,08,3,O,1903702,1480431,423271
2014,08,4,I,1052496,901222,151274
2014,08,4,O,896919,773724,123195
2014,08,5,I,380089,322817,57272
2014,08,5,O,378484,322071,56413
2014,08,6,I,370794,297864,72930
2014,08,6,O,354142,286409,67733
2014,08,7,I,1387091,1204331,182760
2014,08,7,O,1158160,1020860,137300
2014,08,8,I,808014,702655,105359
2014,08,8,O,696608,617180,79428
2014,08,9,I,1914800,1559646,355154
2014,08,9,O,1868377,1530065,338312
2014,08,11,I,2901686,2428149,473537
2014,09,1,I,1248841,960091,288750
2014,09,1,O,1276586,982840,293746
2014,09,2,I,1509664,1291708,217956
2014,09,2,O,1219499,1031032,188467
2014,09,3,I,1501197,1185463,315734
2014,09,3,O,1694280,1348579,345701
2014,09,4,I,1028864,905102,123762
2014,09,4,O,891777,788070,103707
2014,09,5,I,320434,279958,40476
2014,09,5,O,320601,280573,40028
2014,09,6,I,337149,283381,53768
2014,09,6,O,318860,270278,48582
2014,09,7,I,1373388,1210420,162968
2014,09,7,O,1143219,1020618,122601
2014,09,8,I,813375,720394,92981
2014,09,8,O,683192,617052,66140
2014,09,9,I,1777643,1481189,296454
2014,09,9,O,1772551,1486711,285840
2014,09,11,I,2707543,2313448,394095
2014,10,1,I,1271344,980321,291023
2014,10,1,O,1321323,1022121,299202
2014,10,2,I,1554511,1333375,221136
2014,10,2,O,1226667,1040955,185712
2014,10,3,I,1579075,1257726,321349
2014,10,3,O,1743540,1396900,346640
2014,10,4,I,1084140,956994,127146
2014,10,4,O,937330,832318,105012
2014,10,5,I,305424,269548,35876
2014,10,5,O,311014,274488,36526
2014,10,6,I,329546,282983,46563
2014,10,6,O,314951,272589,42362
2014,10,7,I,1429018,1262848,166170
2014,10,7,O,1207906,1083138,124768
2014,10,8,I,901999,796962,105037
2014,10,8,O,720138,650489,69649
2014,10,9,I,1788867,1497680,291187
2014,10,9,O,1797376,1512606,284770
2014,10,11,I,2780472,2390686,389786
2014,11,1,I,1147881,868778,279103
2014,11,1,O,1211210,927156,284054
2014,11,2,I,1440628,1232535,208093
2014,11,2,O,1153699,972598,181101
2014,11,3,I,1498385,1185525,312860
2014,11,3,O,1596974,1267244,329730
2014,11,4,I,1008165,891184,116981
2014,11,4,O,883736,783911,99825
2014,11,5,I,279406,246026,33380
2014,11,5,O,282902,249968,32934
2014,11,6,I,302286,258338,43948
2014,11,6,O,286859,247770,39089
2014,11,7,I,1295558,1140618,154940
2014,11,7,O,1086375,969937,116438
2014,11,8,I,810987,717104,93883
2014,11,8,O,651722,590561,61161
2014,11,9,I,1658354,1377060,281294
2014,11,9,O,1654446,1384666,269780
2014,11,11,I,2611528,2229055,382473
2014,12,1,I,1184550,898123,286427
2014,12,1,O,1250587,956390,294197
2014,12,2,I,1482697,1265022,217675
2014,12,2,O,1171691,985169,186522
2014,12,3,I,1559388,1230901,328487
2014,12,3,O,1702095,1343850,358245
2014,12,4,I,1011157,889466,121691
2014,12,4,O,878000,773952,104048
2014,12,5,I,291649,257266,34383
2014,12,5,O,299401,264384,35017
2014,12,6,I,317828,272319,45509
2014,12,6,O,304503,263013,41490
2014,12,7,I,1335039,1169349,165690
2014,12,7,O,1112646,990134,122512
2014,12,8,I,842669,747049,95620
2014,12,8,O,690844,625878,64966
2014,12,9,I,1681858,1396383,285475
2014,12,9,O,1748032,1460423,287609
2014,12,11,I,2779121,2378597,400524
2015,01,1,I,1059309,810473,248836
2015,01,1,O,1102719,850628,252091
2015,01,2,I,1264715,1086268,178447
2015,01,2,O,970212,817883,152329
2015,01,3,I,1397424,1110395,287029
2015,01,3,O,1496370,1192531,303839
2015,01,4,I,845404,752337,93067
2015,01,4,O,736373,656144,80229
2015,01,5,I,255154,226585,28569
2015,01,5,O,261921,232664,29257
2015,01,6,I,289389,248303,41086
2015,01,6,O,277131,240457,36674
2015,01,7,I,1154976,1022820,132156
2015,01,7,O,963074,866388,96686
2015,01,8,I,698100,624627,73473
2015,01,8,O,579784,530567,49217
2015,01,9,I,1463528,1219913,243615
2015,01,9,O,1510569,1269744,240825
2015,01,11,I,2434190,2094321,339869
2015,02,1,I,999941,765150,234791
2015,02,1,O,1038030,799998,238032
2015,02,2,I,1215546,1042927,172619
2015,02,2,O,947342,800012,147330
2015,02,3,I,1298684,1038799,259885
2015,02,3,O,1406641,1127021,279620
2015,02,4,I,789719,702737,86982
2015,02,4,O,710644,632116,78528
2015,02,5,I,233806,207167,26639
2015,02,5,O,241821,214584,27237
2015,02,6,I,265954,227122,38832
2015,02,6,O,254870,219983,34887
2015,02,7,I,1156400,1022888,133512
2015,02,7,O,976752,879969,96783
2015,02,8,I,705256,630351,74905
2015,02,8,O,590057,539507,50550
2015,02,9,I,1356771,1134541,222230
2015,02,9,O,1400841,1178206,222635
2015,02,11,I,2292179,1980675,311504
2015,03,1,I,1192507,915159,277348
2015,03,1,O,1228912,950085,278827
2015,03,2,I,1479467,1272385,207082
2015,03,2,O,1136461,963076,173385
2015,03,3,I,1571546,1255241,316305
2015,03,3,O,1703685,1363666,340019
2015,03,4,I,942288,834789,107499
2015,03,4,O,846448,748976,97472
2015,03,5,I,292889,260403,32486
2015,03,5,O,291952,259824,32128
2015,03,6,I,321918,276383,45535
2015,03,6,O,304517,264060,40457
2015,03,7,I,1368490,1212793,155697
2015,03,7,O,1146884,1034173,112711
2015,03,8,I,823036,736121,86915
2015,03,8,O,696140,634380,61760
2015,03,9,I,1640909,1372170,268739
2015,03,9,O,1700890,1431817,269073
2015,03,11,I,2676299,2313904,362395
2015,04,1,I,1238296,958064,280232
2015,04,1,O,1294807,1008860,285947
2015,04,2,I,1555594,1344158,211436
2015,04,2,O,1212084,1037564,174520
2015,04,3,I,1671142,1340077,331065
2015,04,3,O,1758964,1408747,350217
2015,04,4,I,1057336,931534,125802
2015,04,4,O,923214,815756,107458
2015,04,5,I,296948,263383,33565
2015,04,5,O,292881,260291,32590
2015,04,6,I,325841,281420,44421
2015,04,6,O,306543,267011,39532
2015,04,7,I,1373301,1219820,153481
2015,04,7,O,1146199,1035847,110352
2015,04,8,I,809745,725797,83948
2015,04,8,O,704373,642450,61923
2015,04,9,I,1706513,1429948,276565
2015,04,9,O,1816288,1533238,283050
2015,04,11,I,2776108,2396108,380000
2015,05,1,I,1319020,1012395,306625
2015,05,1,O,1374741,1060953,313788
2015,05,2,I,1704448,1466247,238201
2015,05,2,O,1354197,1155503,198694
2015,05,3,I,1771814,1413241,358573
2015,05,3,O,1903519,1517741,385778
2015,05,4,I,1125593,982428,143165
2015,05,4,O,975926,854298,121628
2015,05,5,I,355407,312581,42826
2015,05,5,O,346690,305999,40691
2015,05,6,I,369084,313803,55281
2015,05,6,O,348683,298665,50018
2015,05,7,I,1392708,1229368,163340
2015,05,7,O,1124096,1010996,113100
2015,05,8,I,867134,772290,94844
2015,05,8,O,721727,654608,67119
2015,05,9,I,1839008,1528142,310866
2015,05,9,O,1967153,1647852,319301
2015,05,11,I,2930706,2511076,419630
2015,06,1,I,1307109,1009694,297415
2015,06,1,O,1350517,1052556,297961
2015,06,2,I,1713613,1482110,231503
2015,06,2,O,1320420,1130053,190367
2015,06,3,I,1747918,1400674,347244
2015,06,3,O,1870807,1496863,373944
2015,06,4,I,1098802,955326,143476
2015,06,4,O,952700,829500,123200
2015,06,5,I,367264,322227,45037
2015,06,5,O,358491,315596,42895
2015,06,6,I,374199,315488,58711
2015,06,6,O,354796,301191,53605
2015,06,7,I,1305860,1153063,152797
2015,06,7,O,1031397,930982,100415
2015,06,8,I,891212,795686,95526
2015,06,8,O,721153,656356,64797
2015,06,9,I,1794526,1500967,293559
2015,06,9,O,1927643,1623354,304289
2015,06,11,I,2926796,2518101,408695
2015,07,1,I,1327585,1013009,314576
2015,07,1,O,1354591,1042012,312579
2015,07,2,I,1694188,1447223,246965
2015,07,2,O,1280524,1080620,199904
2015,07,3,I,1918524,1520481,398043
2015,07,3,O,1990641,1573334,417307
2015,07,4,I,1119360,960397,158963
2015,07,4,O,949383,815696,133687
2015,07,5,I,421841,359525,62316
2015,07,5,O,410251,350706,59545
2015,07,6,I,417562,337766,79796
2015,07,6,O,395377,321083,74294
2015,07,7,I,1362991,1199180,163811
2015,07,7,O,1126661,1007686,118975
2015,07,8,I,862950,763778,99172
2015,07,8,O,703210,633070,70140
2015,07,9,I,1830119,1507938,322181
2015,07,9,O,2022368,1680859,341509
2015,07,11,I,2957722,2514173,443549
2015,08,1,I,1314265,1002589,311676
2015,08,1,O,1376426,1059964,316462
2015,08,2,I,1745384,1488066,257318
2015,08,2,O,1269109,1065042,204067
2015,08,3,I,1981951,1566020,415931
2015,08,3,O,2025437,1598582,426855
2015,08,4,I,1118611,956133,162478
2015,08,4,O,942358,809129,133229
2015,08,5,I,412679,353462,59217
2015,08,5,O,408637,351448,57189
2015,08,6,I,409634,333022,76612
2015,08,6,O,386780,316746,70034
2015,08,7,I,1377316,1210240,167076
2015,08,7,O,1150968,1028127,122841
2015,08,8,I,835868,741055,94813
2015,08,8,O,728697,654160,74537
2015,08,9,I,1828787,1505667,323120
2015,08,9,O,2070628,1719299,351329
2015,08,11,I,2980121,2529418,450703
2015,09,1,I,1204667,934212,270455
2015,09,1,O,1295202,1011022,284180
2015,09,2,I,1607628,1389305,218323
2015,09,2,O,1239389,1060114,179275
2015,09,3,I,1816078,1460961,355117
2015,09,3,O,1871175,1504058,367117
2015,09,4,I,1045345,908924,136421
2015,09,4,O,899392,785646,113746
2015,09,5,I,342718,301428,41290
2015,09,5,O,344035,302785,41250
2015,09,6,I,357519,303211,54308
2015,09,6,O,337419,288348,49071
2015,09,7,I,1314961,1171483,143478
2015,09,7,O,1108721,1001296,107425
2015,09,8,I,774643,694533,80110
2015,09,8,O,652989,591867,61122
2015,09,9,I,1733684,1454309,279375
2015,09,9,O,1896061,1602937,293124
2015,09,11,I,2770956,2387373,383583
2015,10,1,I,1240843,969967,270876
2015,10,1,O,1337938,1055570,282368
2015,10,2,I,1678511,1458286,220225
2015,10,2,O,1279020,1101008,178012
2015,10,3,I,1839980,1494475,345505
2015,10,3,O,1916436,1554818,361618
2015,10,4,I,1103462,971006,132456
2015,10,4,O,1015895,893869,122026
2015,10,5,I,319067,286097,32970
2015,10,5,O,320433,287208,33225
2015,10,6,I,348413,303614,44799
2015,10,6,O,325904,286594,39310
2015,10,7,I,1417593,1264932,152661
2015,10,7,O,1186179,1076413,109766
2015,10,8,I,877902,790775,87127
2015,10,8,O,731692,667494,64198
2015,10,9,I,1794943,1516258,278685
2015,10,9,O,1907593,1623240,284353
2015,10,11,I,2893203,2515858,377345
2015,11,1,I,1180817,922086,258731
2015,11,1,O,1245763,979969,265794
2015,11,2,I,1546363,1342625,203738
2015,11,2,O,1218649,1047684,170965
2015,11,3,I,1745057,1410820,334237
2015,11,3,O,1825749,1476055,349694
2015,11,4,I,1054093,928107,125986
2015,11,4,O,967992,850284,117708
2015,11,5,I,303136,271107,32029
2015,11,5,O,304674,272936,31738
2015,11,6,I,325341,282875,42466
2015,11,6,O,304597,267398,37199
2015,11,7,I,1309881,1168417,141464
2015,11,7,O,1106422,1003186,103236
2015,11,8,I,801812,722933,78879
2015,11,8,O,718252,653270,64982
2015,11,9,I,1708620,1435666,272954
2015,11,9,O,1810688,1533772,276916
2015,11,11,I,2748798,2381850,366948
2015,12,1,I,1192820,929387,263433
2015,12,1,O,1272350,996629,275721
2015,12,2,I,1568525,1355916,212609
2015,12,2,O,1216287,1041258,175029
2015,12,3,I,1782353,1431724,350629
2015,12,3,O,1878749,1507568,371181
2015,12,4,I,1071687,934332,137355
2015,12,4,O,947631,828618,119013
2015,12,5,I,316130,282678,33452
2015,12,5,O,318203,284957,33246
2015,12,6,I,340758,296162,44596
2015,12,6,O,320978,281051,39927
2015,12,7,I,1288305,1143478,144827
2015,12,7,O,1114147,1005445,108702
2015,12,8,I,843019,761393,81626
2015,12,8,O,731024,667423,63601
2015,12,9,I,1729428,1454895,274533
2015,12,9,O,1824344,1547228,277116
2015,12,11,I,2920855,2529480,391375
2016,01,1,I,1050631,827882,222749
2016,01,1,O,1141545,902516,239029
2016,01,2,I,1345497,1170710,174787
2016,01,2,O,1021473,881091,140382
2016,01,3,I,1572245,1269364,302881
2016,01,3,O,1666936,1348574,318362
2016,01,4,I,914044,808158,105886
2016,01,4,O,822201,725779,96422
2016,01,5,I,268438,241918,26520
2016,01,5,O,272526,245654,26872
2016,01,6,I,303812,265156,38656
2016,01,6,O,286874,252642,34232
2016,01,7,I,1176597,1055389,121208
2016,01,7,O,951319,867652,83667
2016,01,8,I,715983,652239,63744
2016,01,8,O,638728,587430,51298
2016,01,9,I,1539037,1303923,235114
2016,01,9,O,1598859,1366577,232282
2016,01,11,I,2552080,2225211,326869
2016,02,1,I,1070306,840471,229835
2016,02,1,O,1127401,887692,239709
2016,02,2,I,1362386,1184142,178244
2016,02,2,O,1047176,899839,147337
2016,02,3,I,1570882,1272256,298626
2016,02,3,O,1673717,1357636,316081
2016,02,4,I,907226,800737,106489
2016,02,4,O,827762,728925,98837
2016,02,5,I,261582,234686,26896
2016,02,5,O,267953,240505,27448
2016,02,6,I,298276,258603,39673
2016,02,6,O,280904,245998,34906
2016,02,7,I,1210260,1083614,126646
2016,02,7,O,993413,906205,87208
2016,02,8,I,754424,686482,67942
2016,02,8,O,680711,624574,56137
2016,02,9,I,1511077,1279943,231134
2016,02,9,O,1582081,1350279,231802
2016,02,11,I,2556886,2234883,322003
2016,03,1,I,1204622,945830,258792
2016,03,1,O,1274373,1002060,272313
2016,03,2,I,1567631,1361891,205740
2016,03,2,O,1173660,1012141,161519
2016,03,3,I,1836095,1487444,348651
2016,03,3,O,1945237,1577077,368160
2016,03,4,I,1064621,935863,128758
2016,03,4,O,949036,834205,114831
2016,03,5,I,311024,279370,31654
2016,03,5,O,316475,284613,31862
2016,03,6,I,350481,304055,46426
2016,03,6,O,330411,289505,40906
2016,03,7,I,1365892,1222580,143312
2016,03,7,O,1127677,1029614,98063
2016,03,8,I,842444,766095,76349
2016,03,8,O,770091,704940,65151
2016,03,9,I,1742654,1475625,267029
2016,03,9,O,1870429,1595006,275423
2016,03,11,I,2926907,2559072,367835
2016,04,1,I,1185821,926956,258865
2016,04,1,O,1301699,1023138,278561
2016,04,2,I,1556443,1348193,208250
2016,04,2,O,1178245,1019833,158412
2016,04,3,I,1843658,1485743,357915
2016,04,3,O,1922431,1548782,373649
2016,04,4,I,1085695,950291,135404
2016,04,4,O,958895,841337,117558
2016,04,5,I,298383,266790,31593
2016,04,5,O,301903,270364,31539
2016,04,6,I,341713,294817,46896
2016,04,6,O,320917,279926,40991
2016,04,7,I,1341777,1200166,141611
2016,04,7,O,1109863,1010613,99250
2016,04,8,I,822709,745295,77414
2016,04,8,O,748806,683581,65225
2016,04,9,I,1733382,1461457,271925
2016,04,9,O,1843952,1565497,278455
2016,04,11,I,2884461,2510852,373609
2016,05,1,I,1235602,967631,267971
2016,05,1,O,1385534,1092631,292903
2016,05,2,I,1688584,1462081,226503
2016,05,2,O,1291138,1117421,173717
2016,05,3,I,1948171,1569121,379050
2016,05,3,O,2038099,1640975,397124
2016,05,4,I,1188420,1035976,152444
2016,05,4,O,1027919,898121,129798
2016,05,5,I,350855,312453,38402
2016,05,5,O,342709,305977,36732
2016,05,6,I,379487,324308,55179
2016,05,6,O,349660,301975,47685
2016,05,7,I,1313197,1175830,137367
2016,05,7,O,1155254,1049646,105608
2016,05,8,I,873456,789299,84157
2016,05,8,O,780355,710494,69861
2016,05,9,I,1818543,1532620,285923
2016,05,9,O,1992419,1690656,301763
2016,05,11,I,3028045,2630641,397404
2016,06,1,I,1248744,980119,268625
2016,06,1,O,1367452,1075919,291533
2016,06,2,I,1697264,1467277,229987
2016,06,2,O,1328771,1146523,182248
2016,06,3,I,2021291,1633073,388218
2016,06,3,O,2054341,1656889,397452
2016,06,4,I,1190947,1026289,164658
2016,06,4,O,1005453,871493,133960
2016,06,5,I,387634,341499,46135
2016,06,5,O,378071,334334,43737
2016,06,6,I,420817,351296,69521
2016,06,6,O,391996,330422,61574
2016,06,7,I,1336630,1196081,140549
2016,06,7,O,1139254,1035751,103503
2016,06,8,I,858457,775512,82945
2016,06,8,O,762222,694150,68072
2016,06,9,I,1750632,1475829,274803
2016,06,9,O,1977614,1675135,302479
2016,06,11,I,3076855,2669902,406953
2016,07,1,I,1247177,962146,285031
2016,07,1,O,1387703,1073304,314399
2016,07,2,I,1650991,1404794,246197
2016,07,2,O,1298375,1103686,194689
2016,07,3,I,2063675,1638774,424901
2016,07,3,O,2116943,1680108,436835
2016,07,4,I,1149212,971302,177910
2016,07,4,O,948766,807796,140970
2016,07,5,I,426839,365781,61058
2016,07,5,O,419369,360571,58798
2016,07,6,I,431069,347901,83168
2016,07,6,O,406197,330348,75849
2016,07,7,I,1293756,1145867,147889
2016,07,7,O,1068629,963034,105595
2016,07,8,I,812541,726254,86287
2016,07,8,O,711753,639203,72550
2016,07,9,I,1861413,1540185,321228
2016,07,9,O,2012216,1678407,333809
2016,07,11,I,3060630,2614165,446465
2016,08,1,I,1316885,1028802,288083
2016,08,1,O,1399926,1094731,305195
2016,08,2,I,1690149,1447583,242566
2016,08,2,O,1280777,1093315,187462
2016,08,3,I,2055852,1649180,406672
2016,08,3,O,2164894,1735545,429349
2016,08,4,I,1180884,1003368,177516
2016,08,4,O,973348,832462,140886
2016,08,5,I,415207,360750,54457
2016,08,5,O,411270,358371,52899
2016,08,6,I,415574,343414,72160
2016,08,6,O,390624,325594,65030
2016,08,7,I,1275956,1136203,139753
2016,08,7,O,1067659,968136,99523
2016,08,8,I,831022,746874,84148
2016,08,8,O,749769,677578,72191
2016,08,9,I,1868026,1561762,306264
2016,08,9,O,2039746,1717298,322448
2016,08,11,I,3126675,2689457,437218
2016,09,1,I,1186348,941440,244908
2016,09,1,O,1291415,1023508,267907
2016,09,2,I,1601387,1388159,213228
2016,09,2,O,1218041,1055432,162609
2016,09,3,I,1837703,1492654,345049
2016,09,3,O,1913394,1554147,359247
2016,09,4,I,1141147,988432,152715
2016,09,4,O,964516,840339,124177
2016,09,5,I,338055,300627,37428
2016,09,5,O,334716,298252,36464
2016,09,6,I,350918,301224,49694
2016,09,6,O,326614,283131,43483
2016,09,7,I,1089242,977372,111870
2016,09,7,O,986309,899511,86798
2016,09,8,I,785947,710956,74991
2016,09,8,O,701148,640673,60475
2016,09,9,I,1672337,1415718,256619
2016,09,9,O,1822990,1548294,274696
2016,09,11,I,2860522,2487056,373466
2016,10,1,I,1240365,985672,254693
2016,10,1,O,1347504,1070439,277065
2016,10,2,I,1662807,1448493,214314
2016,10,2,O,1287067,1120559,166508
2016,10,3,I,1890169,1544166,346003
2016,10,3,O,1987940,1624585,363355
2016,10,4,I,1178435,1025311,153124
2016,10,4,O,1004672,877891,126781
2016,10,5,I,301206,269702,31504
2016,10,5,O,304311,272946,31365
2016,10,6,I,353171,307375,45796
2016,10,6,O,333950,293663,40287
2016,10,7,I,1070899,960459,110440
2016,10,7,O,964242,883853,80389
2016,10,8,I,788109,715238,72871
2016,10,8,O,704222,646313,57909
2016,10,9,I,1768085,1502217,265868
2016,10,9,O,1920827,1642693,278134
2016,10,11,I,2966697,2586605,380092
2016,11,1,I,1195833,954987,240846
2016,11,1,O,1309634,1046279,263355
2016,11,2,I,1573560,1377373,196187
2016,11,2,O,1210701,1056714,153987
2016,11,3,I,1844212,1511697,332515
2016,11,3,O,1938294,1587343,350951
2016,11,4,I,748238,654966,93272
2016,11,4,O,650979,573135,77844
2016,11,5,I,306606,275024,31582
2016,11,5,O,310436,278370,32066
2016,11,6,I,336573,293049,43524
2016,11,6,O,315445,277710,37735
2016,11,7,I,1054181,948214,105967
2016,11,7,O,949911,870923,78988
2016,11,8,I,750034,684419,65615
2016,11,8,O,713202,656950,56252
2016,11,9,I,1715825,1457760,258065
2016,11,9,O,1864206,1594153,270053
2016,11,11,I,2890140,2527404,362736
2016,12,1,I,1203878,959031,244847
2016,12,1,O,1308553,1040959,267594
2016,12,2,I,1596782,1388431,208351
2016,12,2,O,1203303,1044064,159239
2016,12,3,I,1834289,1486323,347966
2016,12,3,O,1946869,1575378,371491
2016,12,5,I,304104,273200,30904
2016,12,5,O,313090,281058,32032
2016,12,6,I,343223,298530,44693
2016,12,6,O,325899,287342,38557
2016,12,7,I,1001690,896434,105256
2016,12,7,O,951406,868988,82418
2016,12,8,I,772197,705116,67081
2016,12,8,O,709295,653383,55912
2016,12,9,I,1716087,1454960,261127
2016,12,9,O,1857033,1583598,273435
2016,12,11,I,3008236,2625513,382723
2017,01,1,I,1116030,902065,213965
2017,01,1,O,1214806,983365,231441
2017,01,2,I,1474051,1298070,175981
2017,01,2,O,1053141,921928,131213
2017,01,3,I,1715536,1409317,306219
2017,01,3,O,1811763,1489569,322194
2017,01,5,I,279786,253901,25885
2017,01,5,O,286286,258734,27552
2017,01,6,I,324223,285011,39212
2017,01,6,O,306731,273084,33647
2017,01,7,I,271677,246474,25203
2017,01,7,O,236277,216930,19347
2017,01,8,I,54366,49407,4959
2017,01,8,O,52132,47479,4653
2017,01,9,I,1590622,1363013,227609
2017,01,9,O,1707168,1473281,233887
2017,01,11,I,2757796,2429807,327989
2017,02,1,I,1018781,828118,190663
2017,02,1,O,1102018,894042,207976
2017,02,2,I,1304559,1149774,154785
2017,02,2,O,963851,846122,117729
2017,02,3,I,1592898,1317126,275772
2017,02,3,O,1656460,1369727,286733
2017,02,5,I,249181,225843,23338
2017,02,5,O,257678,233475,24203
2017,02,6,I,292734,256747,35987
2017,02,6,O,276289,244995,31294
2017,02,9,I,1468799,1261699,207100
2017,02,9,O,1570293,1356483,213810
2017,02,11,I,2527452,2236282,291170
2017,03,1,I,1123942,923291,200651
2017,03,1,O,1201350,986811,214539
2017,03,2,I,1526202,1352849,173353
2017,03,2,O,1143228,1009296,133932
2017,03,3,I,1847589,1534363,313226
2017,03,3,O,1920581,1595307,325274
2017,03,5,I,293111,266780,26331
2017,03,5,O,302835,275369,27466
2017,03,6,I,341996,302295,39701
2017,03,6,O,324741,289994,34747
2017,03,9,I,1675681,1445406,230275
2017,03,9,O,1805071,1564017,241054
2017,03,11,I,2859019,2536204,322815
2017,04,1,I,1137285,936214,201071
2017,04,1,O,1197025,988547,208478
2017,04,2,I,1517062,1344846,172216
2017,04,2,O,1213804,1070280,143524
2017,04,3,I,1918548,1590823,327725
2017,04,3,O,1950851,1616899,333952
2017,04,5,I,288585,262245,26340
2017,04,5,O,288046,262301,25745
2017,04,6,I,335479,296925,38554
2017,04,6,O,315519,281460,34059
2017,04,9,I,1779062,1527925,251137
2017,04,9,O,1922655,1660302,262353
2017,04,11,I,2947462,2593338,354124
2017,05,1,I,1219242,1015905,203337
2017,05,1,O,1320379,1104588,215791
2017,05,2,I,1581440,1411178,170262
2017,05,2,O,1264568,1122008,142560
2017,05,3,I,1988633,1667194,321439
2017,05,3,O,1966943,1641295,325648
2017,05,9,I,1794087,1546869,247218
2017,05,9,O,2039324,1774453,264871
2017,05,11,I,3101295,2744910,356385
2017,06,1,I,541677,454190,87487
2017,06,1,O,597856,502993,94863
2017,06,2,I,728327,652331,75996
2017,06,2,O,573589,511417,62172
2017,06,3,I,1974978,1654504,320474
2017,06,3,O,2070409,1735007,335402
2017,06,9,I,1870050,1616298,253752
2017,06,9,O,1990166,1731779,258387
2017,06,11,I,3117587,2759508,358079
2017,07,3,I,1994843,1654870,339973
2017,07,3,O,2068426,1717789,350637
2017,07,9,I,1862841,1593107,269734
2017,07,9,O,2055300,1772264,283036
2017,07,11,I,662719,572776,89943
2017,08,3,I,1765184,1488646,276538
2017,08,3,O,1837125,1549930,287195
2017,08,9,I,1618474,1406194,212280
2017,08,9,O,1781074,1561782,219292
2017,09,3,I,1450957,1235390,215567
2017,09,3,O,1504645,1277134,227511
2017,09,9,I,1331553,1167154,164399
2017,09,9,O,1451119,1279155,171964
2017,09,21,I,3057012,2631460,425552
2017,09,22,O,926942,804858,122084
2017,09,24,I,815082,720468,94614
2017,09,24,O,699317,619175,80142
2017,09,25,I,251325,220865,30460
2017,09,25,O,246806,226439,20367
2017,09,26,I,240883,214703,26180
2017,09,26,O,260629,229920,30709
2017,09,27,I,807196,713700,93496
2017,09,27,O,696431,620354,76077
2017,09,28,I,537219,484111,53108
2017,09,28,O,517533,460881,56652
2017,09,30,O,2146438,1942810,203628
2017,10,21,I,1015955,889899,126056
2017,10,22,O,312818,279099,33719
2017,10,23,I,451967,391011,60956
2017,10,23,O,462795,401389,61406
2017,10,24,I,280697,254498,26199
2017,10,24,O,238319,217448,20871
2017,10,25,I,74276,65134,9142
2017,10,25,O,76575,71076,5499
2017,10,26,I,80698,72606,8092
2017,10,26,O,86163,76679,9484
2017,10,27,I,270456,242203,28253
2017,10,27,O,239456,215577,23879
2017,10,28,I,182740,164099,18641
2017,10,28,O,172694,150334,22360
2017,10,29,I,411679,359049,52630
2017,10,29,O,453932,399749,54183
2017,10,30,O,723594,661386,62208
2017,11,21,I,2595498,2258493,337005
2017,11,22,O,804013,711923,92090
2017,11,23,I,1206825,1042438,164387
2017,11,23,O,1216085,1052464,163621
2017,11,24,I,739770,673414,66356
2017,11,24,O,619069,561818,57251
2017,11,25,I,200556,180618,19938
2017,11,25,O,198534,181735,16799
2017,11,26,I,201616,180574,21042
2017,11,26,O,218160,193239,24921
2017,11,27,I,722413,643407,79006
2017,11,27,O,604663,542158,62505
2017,11,28,I,463117,421785,41332
2017,11,28,O,451272,411519,39753
2017,11,29,I,1101017,950079,150938
2017,11,29,O,1199894,1053031,146863
2017,11,30,O,1934578,1762123,172455
2017,12,21,I,3162839,2724891,437948
2017,12,22,O,942584,826066,116518
2017,12,23,I,1441556,1238259,203297
2017,12,23,O,1475818,1268419,207399
2017,12,24,I,855459,774787,80672
2017,12,24,O,716326,640067,76259
2017,12,25,I,234920,212035,22885
2017,12,25,O,235444,215322,20122
2017,12,26,I,247012,220569,26443
2017,12,26,O,266029,234989,31040
2017,12,27,I,840799,743310,97489
2017,12,27,O,733500,654226,79274
2017,12,28,I,569967,516769,53198
2017,12,28,O,549248,499126,50122
2017,12,29,I,1309214,1121485,187729
2017,12,29,O,1415954,1234252,181702
2017,12,30,O,2387781,2167984,219797
2018,01,21,I,3814559,3322978,491581
2018,01,22,O,1121697,982241,139456
2018,01,23,I,1727996,1499091,228905
2018,01,23,O,1815943,1577098,238845
2018,01,24,I,1033698,942487,91211
2018,01,24,O,848849,763058,85791
2018,01,25,I,279835,257416,22419
2018,01,25,O,288575,266130,22445
2018,01,26,I,302929,271239,31690
2018,01,26,O,325888,287876,38012
2018,01,27,I,1071793,960154,111639
2018,01,27,O,891955,803619,88336
2018,01,28,I,706350,643585,62765
2018,01,28,O,695045,637190,57855
2018,01,29,I,1567907,1362945,204962
2018,01,29,O,1672660,1482820,189840
2018,01,30,O,2832144,2572668,259476
2018,02,21,I,3691421,3223540,467881
2018,02,22,O,1072516,935193,137323
2018,02,23,I,1628337,1399049,229288
2018,02,23,O,1717047,1496127,220920
2018,02,24,I,979210,893767,85443
2018,02,24,O,841124,748697,92427
2018,02,25,I,264934,243330,21604
2018,02,25,O,272076,250346,21730
2018,02,26,I,279556,249879,29677
2018,02,26,O,301471,267279,34192
2018,02,27,I,1042349,931590,110759
2018,02,27,O,883001,795725,87276
2018,02,28,I,695010,633495,61515
2018,02,28,O,671369,616447,54922
2018,02,29,I,1495808,1299141,196667
2018,02,29,O,1580232,1402426,177806
2018,02,30,O,2682975,2440778,242197
2018,03,21,I,4248141,3704786,543355
2018,03,22,O,1268539,1109210,159329
2018,03,23,I,1870348,1581672,288676
2018,03,23,O,1943527,1691534,251993
2018,03,24,I,1094198,991694,102504
2018,03,24,O,973975,872623,101352
2018,03,25,I,306262,280299,25963
2018,03,25,O,306642,283197,23445
2018,03,26,I,320376,286116,34260
2018,03,26,O,348527,309410,39117
2018,03,27,I,1148692,1025229,123463
2018,03,27,O,960725,866517,94208
2018,03,28,I,769123,700673,68450
2018,03,28,O,725822,665926,59896
2018,03,29,I,1702158,1460563,241595
2018,03,29,O,1824069,1611787,212282
2018,03,30,O,2997640,2736487,261153
2018,04,21,I,4308197,3755134,553063
2018,04,22,O,1283429,1123425,160004
2018,04,23,I,1954586,1645686,308900
2018,04,23,O,2016429,1753834,262595
2018,04,24,I,1167005,1050862,116143
2018,04,24,O,1039371,904375,134996
2018,04,25,I,314428,290800,23628
2018,04,25,O,311888,288111,23777
2018,04,26,I,323313,287273,36040
2018,04,26,O,353989,311933,42056
2018,04,27,I,1187619,1057512,130107
2018,04,27,O,967284,871158,96126
2018,04,28,I,786068,714987,71081
2018,04,28,O,777724,710720,67004
2018,04,29,I,1747891,1510316,237575
2018,04,29,O,1930841,1704455,226386
2018,04,30,O,3065046,2793620,271426
2018,05,21,I,2978023,2604954,373069
2018,05,21,O,1974020,1708603,265417
2018,05,22,O,1530650,1343748,186902
2018,05,23,I,2070143,1748319,321824
2018,05,23,O,2120046,1844785,275261
2018,05,24,I,1383682,1245395,138287
2018,05,24,O,1206637,1081806,124831
2018,05,25,I,388894,353312,35582
2018,05,25,O,388204,356634,31570
2018,05,26,I,396974,349975,46999
2018,05,26,O,426935,378612,48323
2018,05,27,I,1371942,1221054,150888
2018,05,27,O,1143221,1027205,116016
2018,05,28,I,900956,817406,83550
2018,05,28,O,903842,822370,81472
2018,05,29,I,2046173,1767751,278422
2018,05,29,O,2298774,2024848,273926
2018,05,30,O,3485185,3163599,321586
2018,06,21,I,3062033,2655165,406868
2018,06,21,O,1455495,1252521,202974
2018,06,22,O,1384794,1203138,181656
2018,06,23,I,2122772,1805429,317343
2018,06,23,O,2148091,1849279,298812
2018,06,24,I,1244045,1098148,145897
2018,06,24,O,1069961,950381,119580
2018,06,25,I,401816,363531,38285
2018,06,25,O,392109,356737,35372
2018,06,26,I,386342,336241,50101
2018,06,26,O,419945,367203,52742
2018,06,27,I,1284368,1147687,136681
2018,06,27,O,1019895,909996,109899
2018,06,28,I,823394,742718,80676
2018,06,28,O,833217,752749,80468
2018,06,29,I,1858391,1600173,258218
2018,06,29,O,2087583,1827701,259882
2018,06,30,O,3334438,2993627,340811
2018,07,21,I,2463682,2088458,375224
2018,07,21,O,1894164,1625327,268837
2018,07,22,O,1307909,1127607,180302
2018,07,23,I,2057988,1716720,341268
2018,07,23,O,2100083,1792110,307973
2018,07,24,I,1170643,1024341,146302
2018,07,24,O,981337,863875,117462
2018,07,25,I,416843,372634,44209
2018,07,25,O,409208,369075,40133
2018,07,26,I,389217,334594,54623
2018,07,26,O,422517,364400,58117
2018,07,27,I,1285926,1140968,144958
2018,07,27,O,1055927,929696,126231
2018,07,28,I,757104,679271,77833
2018,07,28,O,776779,698738,78041
2018,07,29,I,1859140,1586083,273057
2018,07,29,O,2064157,1793761,270396
2018,07,30,O,3198488,2863885,334603
2018,08,21,I,2016644,1721711,294933
2018,08,21,O,1558921,1339622,219299
2018,08,22,O,1097991,949711,148280
2018,08,23,I,1691587,1430759,260828
2018,08,23,O,1725737,1468305,257432
2018,08,24,I,942947,827459,115488
2018,08,24,O,787852,694680,93172
2018,08,25,I,316993,283807,33186
2018,08,25,O,309902,281392,28510
2018,08,26,I,293426,254690,38736
2018,08,26,O,319249,278331,40918
2018,08,27,I,1080373,940566,139807
2018,08,27,O,894534,785971,108563
2018,08,28,I,640306,575694,64612
2018,08,28,O,653283,589324,63959
2018,08,29,I,1502568,1276590,225978
2018,08,29,O,1654498,1440727,213771
2018,08,30,O,2643487,2374606,268881
2018,09,21,I,3856224,3323731,532493
2018,09,21,O,315308,268386,46922
2018,09,22,O,1282343,1119236,163107
2018,09,23,I,1970281,1676082,294199
2018,09,23,O,1963993,1689484,274509
2018,09,24,I,1124701,997497,127204
2018,09,24,O,967585,861334,106251
2018,09,25,I,327595,293565,34030
2018,09,25,O,322741,293975,28766
2018,09,26,I,332523,294128,38395
2018,09,26,O,363921,322700,41221
2018,09,27,I,1261269,1066633,194636
2018,09,27,O,1080987,957610,123377
2018,09,28,I,770953,697508,73445
2018,09,28,O,768612,698452,70160
2018,09,29,I,1692482,1441387,251095
2018,09,29,O,1960273,1719071,241202
2018,09,30,O,2996336,2704155,292181
2018,10,21,I,3566071,3104025,462046
2018,10,22,O,1057002,931534,125468
2018,10,23,I,1663125,1427141,235984
2018,10,23,O,1705525,1486063,219462
2018,10,24,I,995538,884606,110932
2018,10,24,O,859851,771802,88049
2018,10,25,I,262467,233325,29142
2018,10,25,O,265370,242841,22529
2018,10,26,I,281042,248844,32198
2018,10,26,O,300948,265796,35152
2018,10,27,I,1145923,976390,169533
2018,10,27,O,957596,851971,105625
2018,10,28,I,706610,645496,61114
2018,10,28,O,709076,649764,59312
2018,10,29,I,1451574,1243182,208392
2018,10,29,O,1637163,1445661,191502
2018,10,30,O,2626339,2388811,237528
2018,11,21,I,4107781,3578287,529494
2018,11,22,O,1275937,1126878,149059
2018,11,23,I,1960346,1683402,276944
2018,11,23,O,1994352,1742589,251763
2018,11,24,I,1141138,1009615,131523
2018,11,24,O,999253,896463,102790
2018,11,25,I,309629,272117,37512
2018,11,25,O,311293,286347,24946
2018,11,26,I,324563,276871,47692
2018,11,26,O,349874,306902,42972
2018,11,27,I,1335809,1141379,194430
2018,11,27,O,1131694,996966,134728
2018,11,28,I,823162,739814,83348
2018,11,28,O,803634,735178,68456
2018,11,29,I,1720556,1478413,242143
2018,11,29,O,1942934,1712067,230867
2018,11,30,O,3083574,2798907,284667
2018,12,21,I,4137409,3584124,553285
2018,12,22,O,1239797,1088876,150921
2018,12,23,I,1964828,1680644,284184
2018,12,23,O,2043544,1756218,287326
2018,12,24,I,1153839,1014608,139231
2018,12,24,O,996913,892367,104546
2018,12,25,I,314197,281011,33186
2018,12,25,O,312925,288365,24560
2018,12,26,I,320846,282200,38646
2018,12,26,O,351151,309605,41546
2018,12,27,I,1308896,1110954,197942
2018,12,27,O,1156968,1017922,139046
2018,12,28,I,837989,752963,85026
2018,12,28,O,817902,745885,72017
2018,12,29,I,1727694,1496771,230923
2018,12,29,O,1943091,1703843,239248
2018,12,30,O,3217716,2915475,302241
2019,01,21,I,3898398,3396014,502384
2019,01,22,O,1142374,1008774,133600
2019,01,23,I,1840085,1591926,248159
2019,01,23,O,1905202,1626728,278474
2019,01,24,I,1036075,922413,113662
2019,01,24,O,892790,808454,84336
2019,01,25,I,290703,264505,26198
2019,01,25,O,297032,274340,22692
2019,01,26,I,315378,278932,36446
2019,01,26,O,341579,300569,41010
2019,01,27,I,1258714,1073790,184924
2019,01,27,O,1066412,939341,127071
2019,01,28,I,775320,703788,71532
2019,01,28,O,763662,696311,67351
2019,01,29,I,1594518,1390922,203596
2019,01,29,O,1768679,1561447,207232
2019,01,30,O,2970365,2709392,260973
2019,02,21,I,3735818,3223249,512569
2019,02,22,O,1093825,963259,130566
2019,02,23,I,1696582,1466113,230469
2019,02,23,O,1762565,1503496,259069
2019,02,24,I,980225,870620,109605
2019,02,24,O,867927,784493,83434
2019,02,25,I,258915,235800,23115
2019,02,25,O,264928,244277,20651
2019,02,26,I,283737,251316,32421
2019,02,26,O,306238,269447,36791
2019,02,27,I,1206179,1022133,184046
2019,02,27,O,1022110,899344,122766
2019,02,28,I,737932,668961,68971
2019,02,28,O,730700,665710,64990
2019,02,29,I,1501349,1305357,195992
2019,02,29,O,1677680,1473275,204405
2019,02,30,O,2751542,2506920,244622
2019,03,21,I,4349868,3754856,595012
2019,03,22,O,1305350,1137898,167452
2019,03,23,I,2011860,1731897,279963
2019,03,23,O,2052978,1749069,303909
2019,03,24,I,1140110,1009707,130403
2019,03,24,O,1031528,928559,102969
2019,03,25,I,312450,284834,27616
2019,03,25,O,316362,290315,26047
2019,03,26,I,331824,292288,39536
2019,03,26,O,355706,312008,43698
2019,03,27,I,1397952,1184377,213575
2019,03,27,O,1175564,1033320,142244
2019,03,28,I,841060,760331,80729
2019,03,28,O,829612,753320,76292
2019,03,29,I,1723486,1495637,227849
2019,03,29,O,1950127,1710235,239892
2019,03,30,O,3162863,2873916,288947
2019,04,21,I,4318137,3736865,581272
2019,04,22,O,1337681,1162065,175616
2019,04,23,I,2031675,1728103,303572
2019,04,23,O,2098803,1796572,302231
2019,04,24,I,1177702,1041728,135974
2019,04,24,O,1052180,945279,106901
2019,04,25,I,308688,279691,28997
2019,04,25,O,307799,282213,25586
2019,04,26,I,325342,285827,39515
2019,04,26,O,357506,308206,49300
2019,04,27,I,1393240,1173773,219467
2019,04,27,O,1155604,1009298,146306
2019,04,28,I,832691,750029,82662
2019,04,28,O,818233,740461,77772
2019,04,29,I,1714240,1487732,226508
2019,04,29,O,1961854,1720176,241678
2019,04,30,O,3165538,2868879,296659
2019,05,21,I,4622155,3987608,634547
2019,05,22,O,1416242,1227354,188888
2019,05,23,I,2152249,1839462,312787
2019,05,23,O,2235950,1901636,334314
2019,05,24,I,1263409,1114700,148709
2019,05,24,O,1107690,993153,114537
2019,05,25,I,376852,339234,37618
2019,05,25,O,368599,336950,31649
2019,05,26,I,368871,323121,45750
2019,05,26,O,415614,350659,64955
2019,05,27,I,1487303,1242285,245018
2019,05,27,O,1229187,1069497,159690
2019,05,28,I,870951,780909,90042
2019,05,28,O,855603,771343,84260
2019,05,29,I,1851315,1599868,251447
2019,05,29,O,2094745,1829039,265706
2019,05,30,O,3319270,3001270,318000
2019,06,21,I,4185972,3596573,589399
2019,06,22,O,1268095,1098901,169194
2019,06,23,I,1975129,1680023,295106
2019,06,23,O,2052515,1735829,316686
2019,06,24,I,1158406,1010200,148206
2019,06,24,O,972334,865347,106987
2019,06,25,I,377392,336939,40453
2019,06,25,O,364497,330940,33557
2019,06,26,I,356667,306118,50549
2019,06,26,O,389936,332390,57546
2019,06,27,I,1335877,1120592,215285
2019,06,27,O,1102544,954004,148540
2019,06,28,I,783512,694736,88776
2019,06,28,O,775012,694894,80118
2019,06,29,I,1697223,1458963,238260
2019,06,29,O,1905578,1652676,252902
2019,06,30,O,3084430,2771933,312497
2019,07,21,I,4506967,3845589,661378
2019,07,22,O,1304652,1122997,181655
2019,07,23,I,2186694,1848455,338239
2019,07,23,O,2239259,1884476,354783
2019,07,24,I,1214233,1048667,165566
2019,07,24,O,967301,855078,112223
2019,07,25,I,459935,403048,56887
2019,07,25,O,443291,395912,47379
2019,07,26,I,423887,359810,64077
2019,07,26,O,457103,384838,72265
2019,07,27,I,1403741,1175501,228240
2019,07,27,O,1162709,998599,164110
2019,07,28,I,796116,701221,94895
2019,07,28,O,811846,721658,90188
2019,07,29,I,1814811,1547781,267030
2019,07,29,O,2094108,1804926,289182
2019,07,30,O,3340872,2978955,361917
2019,08,21,I,4604153,3947624,656529
2019,08,22,O,1326472,1143642,182830
2019,08,23,I,2237131,1893332,343799
2019,08,23,O,2311595,1946788,364807
2019,08,24,I,1272219,1101658,170561
2019,08,24,O,1005876,888382,117494
2019,08,25,I,432731,383226,49505
2019,08,25,O,410957,370969,39988
2019,08,26,I,389657,336822,52835
2019,08,26,O,422694,359277,63417
2019,08,27,I,1453973,1238669,215304
2019,08,27,O,1231196,1054807,176389
2019,08,28,I,816644,722088,94556
2019,08,28,O,819941,731765,88176
2019,08,29,I,1901181,1618067,283114
2019,08,29,O,2117250,1826163,291087
2019,08,30,O,3394857,3014939,379918
2019,09,21,I,4283399,3678539,604860
2019,09,22,O,1233450,1073293,160157
2019,09,23,I,1984717,1690914,293803
2019,09,23,O,2070464,1758930,311534
2019,09,24,I,1151687,1011618,140069
2019,09,24,O,974016,871003,103013
2019,09,25,I,355656,317025,38631
2019,09,25,O,342611,312583,30028
2019,09,26,I,334680,293946,40734
2019,09,26,O,368033,317357,50676
2019,09,27,I,1349940,1159738,190202
2019,09,27,O,1129359,975224,154135
2019,09,28,I,799315,710529,88786
2019,09,28,O,810682,731748,78934
2019,09,29,I,1712708,1467990,244718
2019,09,29,O,1926075,1673409,252666
2019,09,30,O,3099674,2788265,311409
2019,10,21,I,4406087,3820426,585661
2019,10,22,O,1287423,1126303,161120
2019,10,23,I,2099564,1793032,306532
2019,10,23,O,2157932,1847698,310234
2019,10,24,I,1234214,1089099,145115
2019,10,24,O,1057999,949428,108571
2019,10,25,I,334313,299385,34928
2019,10,25,O,328822,300995,27827
2019,10,26,I,331658,294243,37415
2019,10,26,O,362698,315400,47298
2019,10,27,I,1472384,1275526,196858
2019,10,27,O,1218261,1061473,156788
2019,10,28,I,837361,752265,85096
2019,10,28,O,860033,777944,82089
2019,10,29,I,1759878,1517199,242679
2019,10,29,O,2009661,1755296,254365
2019,10,30,O,3229150,2870398,358752
2019,11,21,I,4102409,3566014,536395
2019,11,22,O,1195798,1044854,150944
2019,11,23,I,1935685,1647418,288267
2019,11,23,O,1983315,1694989,288326
2019,11,24,I,1140351,1008533,131818
2019,11,24,O,984988,873634,111354
2019,11,25,I,304635,273622,31013
2019,11,25,O,302441,276803,25638
2019,11,26,I,300522,266650,33872
2019,11,26,O,328875,286403,42472
2019,11,27,I,1320762,1141968,178794
2019,11,27,O,1089758,949077,140681
2019,11,28,I,773369,695857,77512
2019,11,28,O,797424,722228,75196
2019,11,29,I,1627094,1402838,224256
2019,11,29,O,1848764,1610052,238712
2019,11,30,O,2998664,2681273,317391
2019,12,21,I,4235203,3674277,560926
2019,12,22,O,1254368,1094387,159981
2019,12,23,I,1995974,1694600,301374
2019,12,23,O,2078717,1772954,305763
2019,12,24,I,1149737,1022964,126773
2019,12,24,O,968496,868985,99511
2019,12,25,I,320918,289016,31902
2019,12,25,O,315918,289160,26758
2019,12,26,I,313873,278268,35605
2019,12,26,O,344690,299956,44734
2019,12,27,I,1338293,1151536,186757
2019,12,27,O,1132883,983180,149703
2019,12,28,I,821070,738014,83056
2019,12,28,O,816113,736989,79124
2019,12,29,I,1669189,1437495,231694
2019,12,29,O,1878765,1632737,246028
2019,12,30,O,3210054,2895246,314808
2020,01,21,I,3979966,3470225,509741
2020,01,22,O,1117102,975758,141344
2020,01,23,I,1898002,1622226,275776
2020,01,23,O,1977818,1696646,281172
2020,01,24,I,1090995,981469,109526
2020,01,24,O,891751,808335,83416
2020,01,25,I,301419,272297,29122
2020,01,25,O,305192,279801,25391
2020,01,26,I,312647,276916,35731
2020,01,26,O,338785,294903,43882
2020,01,27,I,1287063,1115304,171759
2020,01,27,O,1057680,922470,135210
2020,01,28,I,755534,681580,73954
2020,01,28,O,756040,686169,69871
2020,01,29,I,1557173,1348663,208510
2020,01,29,O,1740665,1525197,215468
2020,01,30,O,3028776,2747520,281256
2020,02,21,I,3848667,3350773,497894
2020,02,22,O,1111788,970758,141030
2020,02,23,I,1829559,1561185,268374
2020,02,23,O,1902332,1630699,271633
2020,02,24,I,1044358,937937,106421
2020,02,24,O,894178,809504,84674
2020,02,25,I,276713,250124,26589
2020,02,25,O,280757,257501,23256
2020,02,26,I,287781,255018,32763
2020,02,26,O,315571,274688,40883
2020,02,27,I,1267893,1099303,168590
2020,02,27,O,1062375,928851,133524
2020,02,28,I,753681,679943,73738
2020,02,28,O,761503,691702,69801
2020,02,29,I,1511963,1308027,203936
2020,02,29,O,1703771,1489773,213998
2020,02,30,O,2890168,2620225,269943
2020,03,21,I,2984082,2573472,410610
2020,03,22,O,828745,715476,113269
2020,03,23,I,1423173,1213578,209595
2020,03,23,O,1509515,1285888,223627
2020,03,24,I,685292,616168,69124
2020,03,24,O,596895,536279,60616
2020,03,25,I,234974,209283,25691
2020,03,25,O,238498,217328,21170
2020,03,26,I,259289,227698,31591
2020,03,26,O,278644,239990,38654
2020,03,27,I,861817,738323,123494
2020,03,27,O,723964,622015,101949
2020,03,28,I,536194,481722,54472
2020,03,28,O,540652,488137,52515
2020,03,29,I,1222255,1054443,167812
2020,03,29,O,1353434,1181684,171750
2020,03,30,O,2374139,2144500,229639
2020,04,21,I,1502691,1271879,230812
2020,04,22,O,381915,318732,63183
2020,04,23,I,731305,614459,116846
2020,04,23,O,784916,658676,126240
2020,04,24,I,242917,217271,25646
2020,04,24,O,209587,185853,23734
2020,04,25,I,150848,129980,20868
2020,04,25,O,155132,139360,15772
2020,04,26,I,179390,155577,23813
2020,04,26,O,187883,159975,27908
2020,04,27,I,311450,261048,50402
2020,04,27,O,273289,225284,48005
2020,04,28,I,218554,191950,26604
2020,04,28,O,196912,172739,24173
2020,04,29,I,740974,631350,109624
2020,04,29,O,758942,653242,105700
2020,04,30,O,1383034,1235332,147702
2020,05,21,I,2355922,1963786,392136
2020,05,22,O,624178,517304,106874
2020,05,23,I,1097535,913799,183736
2020,05,23,O,1184927,985504,199423
2020,05,24,I,426690,374717,51973
2020,05,24,O,367886,321485,46401
2020,05,25,I,236326,201906,34420
2020,05,25,O,238573,212727,25846
2020,05,26,I,259602,222494,37108
2020,05,26,O,271038,228459,42579
2020,05,27,I,493120,408156,84964
2020,05,27,O,412769,339006,73763
2020,05,28,I,375917,327827,48090
2020,05,28,O,333648,289639,44009
2020,05,29,I,1128317,950039,178278
2020,05,29,O,1169549,995873,173676
2020,05,30,O,2027373,1785873,241500
2020,06,21,I,3207761,2653529,554232
2020,06,22,O,868743,716548,152195
2020,06,23,I,1425505,1177566,247939
2020,06,23,O,1536922,1269915,267007
2020,06,24,I,649616,561859,87757
2020,06,24,O,562618,485503,77115
2020,06,25,I,324210,278207,46003
2020,06,25,O,322702,284235,38467
2020,06,26,I,328455,277117,51338
2020,06,26,O,349026,289151,59875
2020,06,27,I,780956,638551,142405
2020,06,27,O,592688,483079,109609
2020,06,28,I,592902,514683,78219
2020,06,28,O,538244,465976,72268
2020,06,29,I,1409851,1182022,227829
2020,06,29,O,1498046,1269763,228283
2020,06,30,O,2550051,2232625,317426
2020,07,21,I,3623540,2976545,646995
2020,07,22,O,1000383,825138,175245
2020,07,23,I,1710302,1396450,313852
2020,07,23,O,1841612,1506928,334684
2020,07,24,I,861464,734951,126513
2020,07,24,O,717634,612556,105078
2020,07,25,I,419985,351158,68827
2020,07,25,O,410412,356076,54336
2020,07,26,I,394809,328166,66643
2020,07,26,O,419270,341817,77453
2020,07,27,I,950378,769303,181075
2020,07,27,O,720120,586223,133897
2020,07,28,I,705292,606099,99193
2020,07,28,O,652966,559747,93219
2020,07,29,I,1583994,1319071,264923
2020,07,29,O,1673028,1409359,263669
2020,07,30,O,2861720,2487322,374398
2020,08,21,I,3736631,3056971,679660
2020,08,22,O,1042771,860103,182668
2020,08,23,I,1848145,1507240,340905
2020,08,23,O,2012469,1639716,372753
2020,08,24,I,946203,804788,141415
2020,08,24,O,796797,678625,118172
2020,08,25,I,404731,334741,69990
2020,08,25,O,384981,336439,48542
2020,08,26,I,364631,306685,57946
2020,08,26,O,393752,324613,69139
2020,08,27,I,1039523,843814,195709
2020,08,27,O,801113,649277,151836
2020,08,28,I,748239,640719,107520
2020,08,28,O,703829,602903,100926
2020,08,29,I,1610758,1341443,269315
2020,08,29,O,1698951,1426473,272478
2020,08,30,O,2985510,2585967,399543
2020,09,21,I,3750582,3081026,669556
2020,09,22,O,1017145,844626,172519
2020,09,23,I,1790704,1466167,324537
2020,09,23,O,1947789,1593950,353839
2020,09,24,I,990122,848318,141804
2020,09,24,O,815028,700231,114797
2020,09,25,I,348440,293706,54734
2020,09,25,O,331014,294307,36707
2020,09,26,I,325476,278379,47097
2020,09,26,O,351729,294580,57149
2020,09,27,I,1081139,886464,194675
2020,09,27,O,812266,665498,146768
2020,09,28,I,760919,654860,106059
2020,09,28,O,726927,626235,100692
2020,09,29,I,1525474,1282323,243151
2020,09,29,O,1658147,1399028,259119
2020,09,30,O,2925365,2548057,377308
2020,10,21,I,3864855,3186579,678276
2020,10,22,O,1054666,879407,175259
2020,10,23,I,1853299,1521982,331317
2020,10,23,O,1955661,1604420,351241
2020,10,24,I,1000801,859422,141379
2020,10,24,O,864220,744921,119299
2020,10,25,I,297940,255980,41960
2020,10,25,O,286700,255939,30761
2020,10,26,I,308109,265414,42695
2020,10,26,O,333193,278773,54420
2020,10,27,I,1129406,921915,207491
2020,10,27,O,869607,716182,153425
2020,10,28,I,792835,684340,108495
2020,10,28,O,763161,660609,102552
2020,10,29,I,1513653,1273622,240031
2020,10,29,O,1691410,1427673,263737
2020,10,30,O,2970507,2599225,371282
2020,11,21,I,3477906,2874888,603018
2020,11,22,O,958055,799298,158757
2020,11,23,I,1634616,1338647,295969
2020,11,23,O,1774629,1453596,321033
2020,11,24,I,857821,738541,119280
2020,11,24,O,747909,647816,100093
2020,11,25,I,269616,230985,38631
2020,11,25,O,264790,235933,28857
2020,11,26,I,282605,242201,40404
2020,11,26,O,302629,254326,48303
2020,11,27,I,981020,801343,179677
2020,11,27,O,760067,627253,132814
2020,11,28,I,699380,605880,93500
2020,11,28,O,655807,567783,88024
2020,11,29,I,1382679,1161170,221509
2020,11,29,O,1510673,1271289,239384
2020,11,30,O,2702899,2363198,339701
2020,12,21,I,3384242,2801997,582245
2020,12,22,O,936611,783683,152928
2020,12,23,I,1596083,1308718,287365
2020,12,23,O,1756065,1437341,318724
2020,12,24,I,816583,701960,114623
2020,12,24,O,688604,597262,91342
2020,12,25,I,258351,221879,36472
2020,12,25,O,253055,225674,27381
2020,12,26,I,272633,234395,38238
2020,12,26,O,292954,246285,46669
2020,12,27,I,966290,802942,163348
2020,12,27,O,744445,615349,129096
2020,12,28,I,687833,596032,91801
2020,12,28,O,658498,566258,92240
2020,12,29,I,1318363,1103734,214629
2020,12,29,O,1420801,1191523,229278
2020,12,30,I,2872442,2452353,420089
2020,12,30,O,2734311,2393354,340957
2021,01,21,I,3338357,2769546,568811
2021,01,22,O,913291,763476,149815
2021,01,23,I,1542714,1264723,277991
2021,01,23,O,1713274,1405135,308139
2021,01,24,I,801552,691778,109774
2021,01,24,O,644297,561525,82772
2021,01,25,I,243545,210703,32842
2021,01,25,O,246402,219782,26620
2021,01,26,I,269199,232192,37007
2021,01,26,O,284954,240588,44366
2021,01,27,I,935127,780378,154749
2021,01,27,O,712941,589129,123812
2021,01,28,I,636800,553116,83684
2021,01,28,O,614097,530075,84022
2021,01,29,I,1315287,1101830,213457
2021,01,29,O,1416023,1187534,228489
2021,01,30,I,2803370,2402888,400482
2021,01,30,O,2658276,2331070,327206
2021,02,21,I,2896578,2404339,492239
2021,02,22,O,809451,679735,129716
2021,02,23,I,1343759,1105343,238416
2021,02,23,O,1486667,1221143,265524
2021,02,24,I,722395,622350,100045
2021,02,24,O,579092,504651,74441
2021,02,25,I,204492,176389,28103
2021,02,25,O,205871,183604,22267
2021,02,26,I,232104,199238,32866
2021,02,26,O,247002,207477,39525
2021,02,27,I,842888,705185,137703
2021,02,27,O,648866,536664,112202
2021,02,28,I,567295,493566,73729
2021,02,28,O,547840,475237,72603
2021,02,29,I,1090609,914952,175657
2021,02,29,O,1190861,1000523,190338
2021,02,30,I,2401774,2074794,326980
2021,02,30,O,2306064,2021209,284855
2021,03,21,I,3832945,3182437,650508
2021,03,22,O,1096749,921664,175085
2021,03,23,I,1789461,1469247,320214
2021,03,23,O,1977839,1623785,354054
2021,03,24,I,999598,860867,138731
2021,03,24,O,840606,729283,111323
2021,03,25,I,284683,245915,38768
2021,03,25,O,276004,247060,28944
2021,03,26,I,310842,267228,43614
2021,03,26,O,336855,283595,53260
2021,03,27,I,1168520,974405,194115
2021,03,27,O,893860,738347,155513
2021,03,28,I,778556,674852,103704
2021,03,28,O,746482,645162,101320
2021,03,29,I,1449006,1217057,231949
2021,03,29,O,1591890,1338664,253226
2021,03,30,I,3086986,2679108,407878
2021,03,30,O,2959928,2599560,360368
2021,04,21,I,3919030,3264478,654552
2021,04,22,O,1120943,944306,176637
2021,04,23,I,1884159,1547129,337030
2021,04,23,O,2004534,1649180,355354
2021,04,24,I,1095013,939407,155606
2021,04,24,O,894634,776208,118426
2021,04,25,I,297208,258112,39096
2021,04,25,O,283553,253919,29634
2021,04,26,I,315311,271808,43503
2021,04,26,O,343244,289472,53772
2021,04,27,I,1125605,940244,185361
2021,04,27,O,860949,715865,145084
2021,04,28,I,794981,688278,106703
2021,04,28,O,780135,673364,106771
2021,04,29,I,1450651,1230185,220466
2021,04,29,O,1643478,1386182,257296
2021,04,30,I,3151595,2743896,407699
2021,04,30,O,3013858,2643362,370496
2021,05,21,I,4049135,3378225,670910
2021,05,22,O,1153810,974426,179384
2021,05,23,I,1961517,1617937,343580
2021,05,23,O,2187047,1805590,381457
2021,05,24,I,1144612,981658,162954
2021,05,24,O,930587,807813,122774
2021,05,25,I,338167,292481,45686
2021,05,25,O,319533,285649,33884
2021,05,26,I,328909,282966,45943
2021,05,26,O,361930,304792,57138
2021,05,27,I,1205130,1009117,196013
2021,05,27,O,929760,775782,153978
2021,05,28,I,801755,693798,107957
2021,05,28,O,773171,667079,106092
2021,05,29,I,1489085,1263165,225920
2021,05,29,O,1656462,1400654,255808
2021,05,30,I,3253235,2837288,415947
2021,05,30,O,3131231,2749168,382063
2021,06,21,I,4165987,3477276,688711
2021,06,22,O,1221516,1029137,192379
2021,06,23,I,2039392,1674466,364926
2021,06,23,O,2248946,1853163,395783
2021,06,24,I,1203975,1024685,179290
2021,06,24,O,931763,805375,126388
2021,06,25,I,401014,343062,57952
2021,06,25,O,370418,328614,41804
2021,06,26,I,364068,309923,54145
2021,06,26,O,402250,336159,66091
2021,06,27,I,1282966,1074920,208046
2021,06,27,O,985149,821970,163179
2021,06,28,I,846965,731141,115824
2021,06,28,O,802726,691141,111585
2021,06,29,I,1504489,1272081,232408
2021,06,29,O,1673321,1410144,263177
2021,06,30,I,3314699,2878527,436172
2021,06,30,O,3219277,2819389,399888
2021,07,21,I,4319817,3594215,725602
2021,07,22,O,1277874,1062797,215077
2021,07,23,I,2172240,1782628,389612
2021,07,23,O,2362733,1942019,420714
2021,07,24,I,1182780,998608,184172
2021,07,24,O,901597,773040,128557
2021,07,25,I,412885,352339,60546
2021,07,25,O,387119,343061,44058
2021,07,26,I,377204,320773,56431
2021,07,26,O,415513,346620,68893
2021,07,27,I,1337895,1120831,217064
2021,07,27,O,1033846,860545,173301
2021,07,28,I,856856,736382,120474
2021,07,28,O,799137,683515,115622
2021,07,29,I,1640971,1379841,261130
2021,07,29,O,1798235,1509890,288345
2021,07,30,I,3450906,2982483,468423
2021,07,30,O,3377035,2946750,430285
2021,08,21,I,4327267,3610023,717244
2021,08,22,O,1269625,1069905,199720
2021,08,23,I,2204229,1812942,391287
2021,08,23,O,2357149,1946289,410860
2021,08,24,I,1228790,1039679,189111
2021,08,24,O,966042,827544,138498
2021,08,25,I,392057,337252,54805
2021,08,25,O,369772,329447,40325
2021,08,26,I,353167,301486,51681
2021,08,26,O,387398,324895,62503
2021,08,27,I,1346210,1131074,215136
2021,08,27,O,1036568,862523,174045
2021,08,28,I,875214,754054,121160
2021,08,28,O,832314,714294,118020
2021,08,29,I,1619640,1365438,254202
2021,08,29,O,1781583,1500064,281519
2021,08,30,I,3433836,2989667,444169
2021,08,30,O,3356869,2941153,415716
2021,09,21,I,4169660,3488359,681301
2021,09,22,O,1247299,1057464,189835
2021,09,23,I,2075094,1717194,357900
2021,09,23,O,2228801,1843496,385305
2021,09,24,I,1205918,1027022,178896
2021,09,24,O,987671,853565,134106
2021,09,25,I,357172,309140,48032
2021,09,25,O,336082,301426,34656
2021,09,26,I,334913,290104,44809
2021,09,26,O,369956,314426,55530
2021,09,27,I,1354417,1148609,205808
2021,09,27,O,1049383,886671,162712
2021,09,28,I,923454,798331,125123
2021,09,28,O,826396,713032,113364
2021,09,29,I,1445988,1222000,223988
2021,09,29,O,1580803,1334099,246704
2021,09,30,I,3240240,2835269,404971
2021,09,30,O,3176916,2803092,373824
2021,10,21,I,4302552,3610154,692398
2021,10,22,O,1206338,1029366,176972
2021,10,23,I,2145885,1782267,363618
2021,10,23,O,2240280,1857745,382535
2021,10,24,I,1270682,1088656,182026
2021,10,24,O,1038730,903990,134740
2021,10,25,I,349313,304240,45073
2021,10,25,O,326459,293448,33011
2021,10,26,I,324497,283452,41045
2021,10,26,O,366053,312715,53338
2021,10,27,I,1408141,1202438,205703
2021,10,27,O,1081380,922745,158635
2021,10,28,I,1019691,889241,130450
2021,10,28,O,909141,790975,118166
2021,10,29,I,1587559,1346659,240900
2021,10,29,O,1819698,1542725,276973
2021,10,30,I,3407745,2997193,410552
2021,10,30,O,3348260,2966105,382155
2021,11,21,I,4069360,3426371,642989
2021,11,22,O,1205713,1034506,171207
2021,11,23,I,2083218,1736445,346773
2021,11,23,O,2165548,1806764,358784
2021,11,24,I,1217273,1046449,170824
2021,11,24,O,979139,851262,127877
2021,11,25,I,324842,282952,41890
2021,11,25,O,307291,277179,30112
2021,11,26,I,299268,261710,37558
2021,11,26,O,341041,290927,50114
2021,11,27,I,1337024,1151879,185145
2021,11,27,O,1068411,917747,150664
2021,11,28,I,958259,837176,121083
2021,11,28,O,864127,753849,110278
2021,11,29,I,1529253,1299362,229891
2021,11,29,O,1734920,1473196,261724
2021,11,30,I,3247638,2873332,374306
2021,11,30,O,3184872,2830590,354282
2021,12,21,I,3949400,3347090,602310
2021,12,22,O,1151472,992349,159123
2021,12,23,I,1969216,1642227,326989
2021,12,23,O,2088143,1743402,344741
2021,12,24,I,1102071,949775,152296
2021,12,24,O,883579,770237,113342
2021,12,25,I,311887,274946,36941
2021,12,25,O,294900,267723,27177
2021,12,26,I,295649,260225,35424
2021,12,26,O,331541,284952,46589
2021,12,27,I,1268588,1091635,176953
2021,12,27,O,1038613,893400,145213
2021,12,28,I,937167,821616,115551
2021,12,28,O,840335,734756,105579
2021,12,29,I,1519321,1293282,226039
2021,12,29,O,1677012,1425894,251118
2021,12,30,I,3261537,2895215,366322
2021,12,30,O,3188706,2840197,348509
2022,01,21,I,3360785,2849720,511065
2022,01,22,O,976077,838641,137436
2022,01,23,I,1662699,1388324,274375
2022,01,23,O,1763329,1473612,289717
2022,01,24,I,859855,749591,110264
2022,01,24,O,697110,612138,84972
2022,01,25,I,258132,229008,29124
2022,01,25,O,254792,231129,23663
2022,01,26,I,263097,232678,30419
2022,01,26,O,287686,248972,38714
2022,01,27,I,1071950,923227,148723
2022,01,27,O,845905,723875,122030
2022,01,28,I,790637,695263,95374
2022,01,28,O,711036,624370,86666
2022,01,29,I,1306862,1116733,190129
2022,01,29,O,1422996,1215004,207992
2022,01,30,I,2822679,2524092,298587
2022,01,30,O,2746766,2460131,286635
2022,02,21,I,3565219,3023601,541618
2022,02,22,O,1079714,929734,149980
2022,02,23,I,1708103,1431617,276486
2022,02,23,O,1842101,1544401,297700
2022,02,24,I,984128,855083,129045
2022,02,24,O,796005,697831,98174
2022,02,25,I,269368,237851,31517
2022,02,25,O,255108,231176,23932
2022,02,26,I,257626,227962,29664
2022,02,26,O,289433,248146,41287
2022,02,27,I,1200151,1035436,164715
2022,02,27,O,947145,818227,128918
2022,02,28,I,882481,776650,105831
2022,02,28,O,777098,683003,94095
2022,02,29,I,1386324,1185764,200560
2022,02,29,O,1551714,1324922,226792
2022,02,30,I,2895960,2590863,305097
2022,02,30,O,2835415,2541576,293839
2022,03,21,I,4217138,3588788,628350
2022,03,22,O,1299646,1126424,173222
2022,03,23,I,2089266,1752377,336889
2022,03,23,O,2182966,1831966,351000
2022,03,24,I,1146438,997391,149047
2022,03,24,O,951086,834282,116804
2022,03,25,I,320160,282846,37314
2022,03,25,O,309934,281321,28613
2022,03,26,I,308171,273184,34987
2022,03,26,O,343141,299282,43859
2022,03,27,I,1421913,1234959,186954
2022,03,27,O,1143340,993351,149989
2022,03,28,I,1028127,903895,124232
2022,03,28,O,901721,792578,109143
2022,03,29,I,1489957,1277847,212110
2022,03,29,O,1719713,1472577,247136
2022,03,30,I,3332139,2983320,348819
2022,03,30,O,3245076,2911555,333521
2022,04,21,I,4079844,3460713,619131
2022,04,22,O,1273285,1101611,171674
2022,04,23,I,2074758,1760351,314407
2022,04,23,O,2147795,1798607,349188
2022,04,24,I,1140853,986983,153870
2022,04,24,O,927461,809442,118019
2022,04,25,I,297054,261978,35076
2022,04,25,O,281020,254663,26357
2022,04,26,I,283289,250531,32758
2022,04,26,O,317575,276705,40870
2022,04,27,I,1360779,1182938,177841
2022,04,27,O,1093994,949403,144591
2022,04,28,I,951110,835141,115969
2022,04,28,O,832204,731366,100838
2022,04,29,I,1434317,1227068,207249
2022,04,29,O,1664921,1421559,243362
2022,04,30,I,3199805,2852334,347471
2022,04,30,O,3113151,2782879,330272
2022,05,21,I,4136636,3482820,653816
2022,05,22,O,1309781,1123316,186465
2022,05,23,I,2112062,1780275,331787
2022,05,23,O,2173495,1802556,370939
2022,05,24,I,1185459,1017676,167783
2022,05,24,O,936688,813766,122922
2022,05,25,I,358400,311022,47378
2022,05,25,O,331175,297637,33538
2022,05,26,I,326950,284842,42108
2022,05,26,O,358337,308021,50316
2022,05,27,I,1375513,1186937,188576
2022,05,27,O,1099413,947792,151621
2022,05,28,I,963611,839081,124530
2022,05,28,O,821806,716891,104915
2022,05,29,I,1483602,1260325,223277
2022,05,29,O,1729434,1465339,264095
2022,05,30,I,3243385,2871850,371535
2022,05,30,O,3165630,2807882,357748
2022,06,21,I,4356650,3672633,684017
2022,06,22,O,1393252,1194789,198463
2022,06,23,I,2238223,1888200,350023
2022,06,23,O,2270116,1887153,382963
2022,06,24,I,1269869,1089456,180413
2022,06,24,O,976173,847085,129088
2022,06,25,I,402324,349387,52937
2022,06,25,O,370422,333820,36602
2022,06,26,I,349869,304516,45353
2022,06,26,O,393888,337973,55915
2022,06,27,I,1463201,1263199,200002
2022,06,27,O,1176645,1015167,161478
2022,06,28,I,1038058,905952,132106
2022,06,28,O,889117,775212,113905
2022,06,29,I,1618277,1375472,242805
2022,06,29,O,1862675,1576740,285935
2022,06,30,I,3468419,3076232,392187
2022,06,30,O,3394316,3019021,375295
2022,07,21,I,3315202,2777181,538021
2022,07,22,O,1052171,890237,161934
2022,07,23,I,1783746,1492568,291178
2022,07,23,O,1775200,1463678,311522
2022,07,24,I,910463,772634,137829
2022,07,24,O,706775,606322,100453
2022,07,25,I,335682,290443,45239
2022,07,25,O,315462,281376,34086
2022,07,26,I,290211,248877,41334
2022,07,26,O,314457,266337,48120
2022,07,27,I,1085403,927177,158226
2022,07,27,O,878819,749500,129319
2022,07,28,I,750480,648154,102326
2022,07,28,O,642433,554034,88399
2022,07,29,I,1259516,1060746,198770
2022,07,29,O,1467194,1232225,234969
2022,07,30,I,2678664,2356921,321743
2022,07,30,O,2617426,2307678,309748
2022,08,21,I,4463493,3752463,711030
2022,08,22,O,1406607,1199308,207299
2022,08,23,I,2350459,1979132,371327
2022,08,23,O,2326597,1931862,394735
2022,08,24,I,1241877,1056481,185396
2022,08,24,O,923323,794449,128874
2022,08,25,I,404255,352943,51312
2022,08,25,O,384373,346026,38347
2022,08,26,I,353062,306588,46474
2022,08,26,O,389850,333793,56057
2022,08,27,I,1455976,1247153,208823
2022,08,27,O,1189890,1015720,174170
2022,08,28,I,1019120,882503,136617
2022,08,28,O,892758,772483,120275
2022,08,29,I,1615767,1367331,248436
2022,08,29,O,1920321,1618804,301517
2022,08,30,I,3505503,3100967,404536
2022,08,30,O,3432009,3040430,391579
2022,09,21,I,3153974,2660838,493136
2022,09,22,O,1003642,861447,142195
2022,09,23,I,1577376,1332189,245187
2022,09,23,O,1640118,1362959,277159
2022,09,24,I,900991,773182,127809
2022,09,24,O,673303,585514,87789
2022,09,25,I,262237,231498,30739
2022,09,25,O,247887,223707,24180
2022,09,26,I,234115,204745,29370
2022,09,26,O,262894,226871,36023
2022,09,27,I,1036870,894801,142069
2022,09,27,O,844727,727013,117714
2022,09,28,I,728126,630883,97243
2022,09,28,O,625255,541936,83319
2022,09,29,I,1190413,1009671,180742
2022,09,29,O,1313125,1111208,201917
2022,09,30,I,2465568,2191618,273950
2022,09,30,O,2407307,2142850,264457
2022,10,21,I,4310917,3645915,665002
2022,10,22,O,1410474,1214893,195581
2022,10,23,I,2099938,1776042,323896
2022,10,23,O,2216606,1846462,370144
2022,10,24,I,1268481,1090610,177871
2022,10,24,O,972686,846937,125749
2022,10,25,I,325006,286589,38417
2022,10,25,O,303189,275195,27994
2022,10,26,I,307077,270526,36551
2022,10,26,O,344335,298623,45712
2022,10,27,I,1474321,1276470,197851
2022,10,27,O,1220581,1055016,165565
2022,10,28,I,1038586,909377,129209
2022,10,28,O,886417,774962,111455
2022,10,29,I,1682116,1426863,255253
2022,10,29,O,1840244,1558085,282159
2022,10,30,I,3397668,3028589,369079
2022,10,30,O,3317877,2960123,357754
2022,11,21,I,4090724,3467852,622872
2022,11,22,O,1338517,1152715,185802
2022,11,23,I,2010655,1704636,306019
2022,11,23,O,2145482,1788588,356894
2022,11,24,I,1185928,1023540,162388
2022,11,24,O,918461,801448,117013
2022,11,25,I,305676,271167,34509
2022,11,25,O,296426,269263,27163
2022,11,26,I,290592,256994,33598
2022,11,26,O,320741,279178,41563
2022,11,27,I,1364805,1179009,185796
2022,11,27,O,1124764,970021,154743
2022,11,28,I,979899,855972,123927
2022,11,28,O,841777,734409,107368
2022,11,29,I,1602756,1361829,240927
2022,11,29,O,1736645,1470029,266616
2022,11,30,I,3263357,2910426,352931
2022,11,30,O,3171365,2830725,340640
2022,12,21,I,4118398,3484736,633662
2022,12,22,O,1333074,1147509,185565
2022,12,23,I,1997215,1690393,306822
2022,12,23,O,2135578,1774510,361068
2022,12,24,I,1143743,985672,158071
2022,12,24,O,880343,765653,114690
2022,12,25,I,305367,270844,34523
2022,12,25,O,293420,266231,27189
2022,12,26,I,286069,253663,32406
2022,12,26,O,317411,277325,40086
2022,12,27,I,1341998,1154109,187889
2022,12,27,O,1118731,963598,155133
2022,12,28,I,997326,871939,125387
2022,12,28,O,862238,749872,112366
2022,12,29,I,1573714,1334071,239643
2022,12,29,O,1750048,1478556,271492
2022,12,30,I,3387423,3016442,370981
2022,12,30,O,3292341,2937099,355242
2023,01,21,I,3915909,3317396,598513
2023,01,22,O,1239947,1063455,176492
2023,01,23,I,1886142,1600014,286128
2023,01,23,O,2057242,1718307,338935
2023,01,24,I,1053809,915904,137905
2023,01,24,O,838006,733606,104400
2023,01,25,I,287794,255010,32784
2023,01,25,O,285740,259566,26174
2023,01,26,I,284046,252407,31639
2023,01,26,O,309750,270745,39005
2023,01,27,I,1299498,1115600,183898
2023,01,27,O,1040770,894185,146585
2023,01,28,I,930071,811903,118168
2023,01,28,O,823134,716322,106812
2023,01,29,I,1535847,1306752,229095
2023,01,29,O,1691859,1432675,259184
2023,01,30,I,3203736,2871394,332342
2023,01,30,O,3133631,2805832,327799
2023,02,21,I,3648060,3097413,550647
2023,02,22,O,1168767,1005364,163403
2023,02,23,I,1744568,1483851,260717
2023,02,23,O,1872365,1566550,305815
2023,02,24,I,992274,860511,131763
2023,02,24,O,785957,684662,101295
2023,02,25,I,261076,230988,30088
2023,02,25,O,255757,232591,23166
2023,02,26,I,254734,225829,28905
2023,02,26,O,279351,244621,34730
2023,02,27,I,1230814,1055793,175021
2023,02,27,O,990920,857065,133855
2023,02,28,I,874836,766969,107867
2023,02,28,O,795442,692960,102482
2023,02,29,I,1425678,1213367,212311
2023,02,29,O,1594046,1350426,243620
2023,02,30,I,2931192,2629937,301255
2023,02,30,O,2891012,2589039,301973
2023,03,21,I,4151111,3534271,616840
2023,03,22,O,1325995,1146727,179268
2023,03,23,I,1977807,1685978,291829
2023,03,23,O,2060194,1729780,330414
2023,03,24,I,1136778,989510,147268
2023,03,24,O,908147,790092,118055
2023,03,25,I,309313,271524,37789
2023,03,25,O,298655,271125,27530
2023,03,26,I,298116,265616,32500
2023,03,26,O,326259,286161,40098
2023,03,27,I,1398500,1208959,189541
2023,03,27,O,1098711,954639,144072
2023,03,28,I,991205,870575,120630
2023,03,28,O,896493,781862,114631
2023,03,29,I,1582070,1351657,230413
2023,03,29,O,1776295,1511661,264634
2023,03,30,I,3273334,2938512,334822
2023,03,30,O,3237567,2905059,332508
2023,04,21,I,4088485,3467141,621344
2023,04,22,O,1310208,1128637,181571
2023,04,23,I,1966097,1667353,298744
2023,04,23,O,2021985,1688564,333421
2023,04,24,I,1135579,981852,153727
2023,04,24,O,908373,785610,122763
2023,04,25,I,290811,257759,33052
2023,04,25,O,278567,252621,25946
2023,04,26,I,280750,249055,31695
2023,04,26,O,307046,268657,38389
2023,04,27,I,1335732,1149426,186306
2023,04,27,O,1085255,938361,146894
2023,04,28,I,937500,820941,116559
2023,04,28,O,847847,737823,110024
2023,04,29,I,1640616,1390899,249717
2023,04,29,O,1800664,1525539,275125
2023,04,30,I,3215209,2869040,346169
2023,04,30,O,3167150,2828002,339148
2023,05,21,I,4621050,3906395,714655
2023,05,22,O,1491249,1283600,207649
2023,05,23,I,2159650,1829182,330468
2023,05,23,O,2210064,1840507,369557
2023,05,24,I,1294972,1117710,177262
2023,05,24,O,1036159,896479,139680
2023,05,25,I,375658,331581,44077
2023,05,25,O,345932,312580,33352
2023,05,26,I,337510,297047,40463
2023,05,26,O,370779,322354,48425
2023,05,27,I,1483469,1270872,212597
2023,05,27,O,1173773,1012277,161496
2023,05,28,I,1047261,914439,132822
2023,05,28,O,933648,810966,122682
2023,05,29,I,1824887,1546561,278326
2023,05,29,O,2041624,1725403,316221
2023,05,30,I,3575107,3182615,392492
2023,05,30,O,3495867,3117931,377936
2023,06,21,I,4493990,3786672,707318
2023,06,22,O,1452162,1246991,205171
2023,06,23,I,2139237,1801565,337672
2023,06,23,O,2183331,1811516,371815
2023,06,24,I,1261144,1079961,181183
2023,06,24,O,983764,841545,142219
2023,06,25,I,386625,341372,45253
2023,06,25,O,352098,318014,34084
2023,06,26,I,331753,290971,40782
2023,06,26,O,371252,321287,49965
2023,06,27,I,1452138,1240342,211796
2023,06,27,O,1155693,994409,161284
2023,06,28,I,1034442,902693,131749
2023,06,28,O,919521,796118,123403
2023,06,29,I,1837253,1549376,287877
2023,06,29,O,2010629,1690490,320139
2023,06,30,I,3542785,3142206,400579
2023,06,30,O,3517761,3114386,403375
2023,07,21,I,4460254,3725470,734784
2023,07,22,O,1414483,1199715,214768
2023,07,23,I,2178848,1823248,355600
2023,07,23,O,2256227,1889290,366937
2023,07,24,I,1190164,1007895,182269
2023,07,24,O,909709,771430,138279
2023,07,25,I,431672,375281,56391
2023,07,25,O,400356,358307,42049
2023,07,26,I,366001,315392,50609
2023,07,26,O,406936,346447,60489
2023,07,27,I,1413905,1198066,215839
2023,07,27,O,1144659,974809,169850
2023,07,28,I,986252,850569,135683
2023,07,28,O,868270,742559,125711
2023,07,29,I,1877259,1569592,307667
2023,07,29,O,2051806,1710932,340874
2023,07,30,I,3552386,3122793,429593
2023,07,30,O,3464351,3050186,414165
2023,08,21,I,4570828,3827136,743692
2023,08,22,O,1448607,1231956,216651
2023,08,23,I,2242361,1876798,365563
2023,08,23,O,2262581,1891602,370979
2023,08,24,I,1234030,1044757,189273
2023,08,24,O,920736,781149,139587
2023,08,25,I,405994,349665,56329
2023,08,25,O,379187,341003,38184
2023,08,26,I,334174,290856,43318
2023,08,26,O,373511,321028,52483
2023,08,27,I,1435289,1216597,218692
2023,08,27,O,1188684,1017823,170861
2023,08,28,I,1028472,889714,138758
2023,08,28,O,929784,798241,131543
2023,08,29,I,1835165,1542607,292558
2023,08,29,O,2084531,1746341,338190
2023,08,30,I,3553152,3142043,411109
2023,08,30,O,3504227,3096719,407508
2023,09,21,I,4161789,3495987,665802
2023,09,22,O,1331017,1139826,191191
2023,09,23,I,2015714,1694204,321510
2023,09,23,O,2041143,1716693,324450
2023,09,24,I,1098653,940682,157971
2023,09,24,O,902962,772481,130481
2023,09,25,I,343545,299045,44500
2023,09,25,O,313802,283018,30784
2023,09,26,I,297856,261207,36649
2023,09,26,O,336269,290299,45970
2023,09,27,I,1363702,1168373,195329
2023,09,27,O,1114146,967747,146399
2023,09,28,I,979986,851364,128622
2023,09,28,O,856621,740884,115737
2023,09,29,I,1648950,1390346,258604
2023,09,29,O,1847137,1551422,295715
2023,09,30,I,3213951,2852799,361152
2023,09,30,O,3172508,2812404,360104
2023,10,21,I,4313657,3625750,687907
2023,10,22,O,1403213,1205496,197717
2023,10,23,I,2020247,1700657,319590
2023,10,23,O,2112556,1779652,332904
2023,10,24,I,1191095,1022164,168931
2023,10,24,O,962830,826700,136130
2023,10,25,I,327227,288924,38303
2023,10,25,O,303058,273634,29424
2023,10,26,I,292320,256472,35848
2023,10,26,O,330518,286047,44471
2023,10,27,I,1424155,1223763,200392
2023,10,27,O,1208217,1051504,156713
2023,10,28,I,1054323,919517,134806
2023,10,28,O,911431,793796,117635
2023,10,29,I,1713073,1448198,264875
2023,10,29,O,1884708,1587693,297015
2023,10,30,I,3328744,2962534,366210
2023,10,30,O,3286788,2917527,369261
2023,11,21,I,4301682,3626404,675278
2023,11,22,O,1375265,1187355,187910
2023,11,23,I,2011182,1697503,313679
2023,11,23,O,2100119,1769297,330822
2023,11,24,I,1186220,1018766,167454
2023,11,24,O,951166,819954,131212
2023,11,25,I,311867,276411,35456
2023,11,25,O,298475,269913,28562
2023,11,26,I,281644,248147,33497
2023,11,26,O,315295,273575,41720
2023,11,27,I,1386178,1192469,193709
2023,11,27,O,1137129,989029,148100
2023,11,28,I,995526,869105,126421
2023,11,28,O,902959,786070,116889
2023,11,29,I,1718987,1452702,266285
2023,11,29,O,1883333,1586956,296377
2023,11,30,I,3321882,2956506,365376
2023,11,30,O,3252255,2896523,355732
2023,12,21,I,4275194,3600776,674418
2023,12,22,O,1374738,1187219,187519
2023,12,23,I,1983748,1669341,314407
2023,12,23,O,2088444,1754546,333898
2023,12,24,I,1137574,974227,163347
2023,12,24,O,913130,784295,128835
2023,12,25,I,314746,278276,36470
2023,12,25,O,295829,267610,28219
2023,12,26,I,281691,248026,33665
2023,12,26,O,317206,275009,42197
2023,12,27,I,1355803,1162298,193505
2023,12,27,O,1126808,980064,146744
2023,12,28,I,997937,871495,126442
2023,12,28,O,911440,792058,119382
2023,12,29,I,1711215,1441511,269704
2023,12,29,O,1863432,1563994,299438
2023,12,30,I,3433756,3052691,381065
2023,12,30,O,3367962,2992037,375925
2024,01,21,I,2537589,2141996,395593
2024,01,22,O,783651,675799,107852
2024,01,23,I,1160957,979141,181816
2024,01,23,O,1242801,1048103,194698
2024,01,24,I,592666,513378,79288
2024,01,24,O,505435,434240,71195
2024,01,25,I,181411,161763,19648
2024,01,25,O,177398,161289,16109
2024,01,26,I,175432,154923,20509
2024,01,26,O,192160,167129,25031
2024,01,27,I,796935,685423,111512
2024,01,27,O,678353,588746,89607
2024,01,28,I,575549,504412,71137
2024,01,28,O,521608,454682,66926
2024,01,29,I,1030520,871889,158631
2024,01,29,O,1069893,904554,165339
2024,01,30,I,1992364,1787391,204973
2024,01,30,O,1976201,1759437,216764
